,id,name,required_age,is_free,developers,review_score,total_positive,total_negative,total_reviews
0,1198490,All That Remains: Part 1,0,False,Glitch Games,0,1,3,4
1,1198510,Paperball,0,False,Cliax Games,8,130,4,134
2,1198550,Moderium,0,False,All Saints Gaming,0,1,0,1
3,1198600,Pizza Time Explosion,0,False,Electric Prune Juice,7,17,1,18
4,1198630,Customer Cums First!,0,False,Miel,7,8,2,10
5,1198700,Chained: A Victorian Nightmare,0,False,MWM Interactive,6,12,4,16
6,1198730,Hentai Police,0,False,Podval Games,8,105,22,127
7,1198740,Colony Siege,0,False,Finifugal Games,8,72,6,78
8,1198810,Wolf and Pigs,0,False,Visual Light,0,5,1,6
9,1198820,Monster Girl Garden,0,False,Noxious Games,5,9,5,14
10,1198210,Dogworld,0,False,Lateralis,8,55,1,56
11,1198220,Slave Girl Reno,0,False,Aphrodite,0,1,2,3
12,1198240,Danger City,0,False,Hash Technology,0,2,2,4
13,1198270,The Button Witch,0,False,DDreams Games,0,7,0,7
14,1198290,Space Block Buster,0,False,Reality MagiQ,7,14,0,14
15,1198310,Mr.King Luo!Don't be kidding,0,False,艾斯貝洛,0,1,0,1
16,1198340,Summoner VR,0,False,Broadway Entertainment Group Interactive,0,1,0,1
17,1198380,COWBOY YAKUZA,0,False,Active Gaming Media Inc.,0,2,1,3
18,1198390,Kawaii Girl,0,False,MoeGame,0,4,2,6
19,1198400,Rhythm Fighter,0,False,echo games,7,14,0,14
20,1198440,The Burning Descent,0,False,RyseUp Studios,0,2,0,2
21,1198450,The Secret Order 8: Return to the Buried Kingdom,0,False,Sunward Games,7,25,5,30
22,1197990,"Shoot, push, portals",0,False,CrewLab,7,11,1,12
23,1198020,Braverz,0,False,Evil Noob Studios,0,0,1,1
24,1198040,Wide Ocean Big Jacket,0,False,Turnfollow,8,133,4,137
25,1198050,War Remains: Dan Carlin Presents an Immersive Memory,0,False,Flight School Studio,6,55,17,72
26,1198060,Christmas Stories: Enchanted Express Collector's Edition,0,False,Elephant Games,0,4,2,6
27,1198070,The Christmas Spirit: Grimm Tales Collector's Edition,0,False,Domini Games,0,8,0,8
28,1198080,Westminster Darkly,0,False,Studio Incorrect,0,1,1,2
29,1198090,The Legend of Heroes: Trails of Cold Steel IV,0,False,Nihon Falcom,8,625,38,663
30,1198110,Fantasy Realm TD,0,False,Gyro-Games Inc.,0,2,1,3
31,1197520,Familia,0,False,Joseph Abraham,7,13,0,13
32,1197530,Planet Modular TD,0,False,Gyro-Games Inc.,0,4,1,5
33,1197550,Ouction,0,False,Hurricane Dot Com,4,4,13,17
34,1197570,Until We Die,0,False,Pixeye Games,6,400,121,521
35,1197590,Waifu Uncovered,0,False,One-Hand-Free Studios,7,38,8,46
36,1197670,Robin Hood: Country Heroes,0,False,Game On Production,0,1,0,1
37,1197700,Hermes: War of the Gods,0,False,Platinum Games,0,1,0,1
38,1197710,Golden Rails: Tales of the Wild West,0,False,Yustas Game Studio,0,2,0,2
39,1197770,Lilly Knight and the Three Cities of Lust,0,False,HFTGames,6,93,27,120
40,1197820,Craftlands Workshoppe,0,False,Arvydas Žemaitis,6,35,10,45
41,1197840,The incredible friends,0,False,Sun & Eyes,0,0,1,1
42,1197010,TAL: Wizard's Adventures,0,False,Snkl Studio,0,4,1,5
43,1197020,Tale of the Gallant Jiraiya,0,False,Brave Rock Games,0,1,0,1
44,1197030,Mystic Pillars: A Story-Based Puzzle Game,0,False,Holy Cow Productions,7,32,2,34
45,1197060,FUNGI,0,True,Nonline Studios,0,2,0,2
46,1197100,Red Mercenary,0,False,Nicolas Zurek,0,4,2,6
47,1197110,Advancity,0,False,Tbjbu2,0,1,4,5
48,1197150,Em-A-Li,0,False,Yobob,0,5,1,6
49,1197210,HentaiTeachers,0,False,GAO,0,3,1,4
50,1197230,Biba`s Adventures — Hardcore Platformer,0,False,Volrest,0,8,1,9
51,1197340,Dead territory,0,False,Kedexa,0,0,1,1
52,1197350,Santa's Big Sack,0,False,Great Idea Games,7,11,0,11
53,1197360,The Santa Challenge,0,False,CCS,0,1,0,1
54,1197370,Suite 776,0,False,Stanislaw Truchowski,8,228,22,250
55,1197380,Flashover MegaSector,0,False,Happy Frog Games,0,1,0,1
56,1197390,Robot Island,0,False,New Beings,7,19,0,19
57,1197500,Groove Runner,0,False,Milgamsoft,0,1,0,1
58,1196750,Hentai Match Fantasy Stories,0,False,Ero Team Triangle,0,4,3,7
59,1196800,TaniNani,0,False,WhyKev,7,14,0,14
60,1196890,Puzzle Tower,0,False,CRGames,7,9,1,10
61,1196940,Particulate,0,False,Mike Turitzin,0,5,0,5
62,1196970,Vile Matter,0,False,Decoy Software,0,3,0,3
63,1196260,Draft Day Sports: Pro Basketball 2020,0,False,Wolverine Studios,0,2,4,6
64,1196280,Pussy Puzzle,0,False,SpielmannSpiel,0,3,0,3
65,1196350,ATROFIL: THE KEY,0,False,MiL_Puzzle,0,0,1,1
66,1196380,Automaton,0,False,Cicle Interactive,0,1,2,3
67,1196390,Fairy Godmother Stories: Cinderella Collector's Edition,0,False,Domini Games,0,5,0,5
68,1196400,Mystery Case Files: Black Crown Collector's Edition,0,False,Eipix Entertainment,7,20,5,25
69,1196440,Potion Party,0,False,RPGames,7,12,0,12
70,1196450,Stop Sign VR Tools,0,False,Reality Inside Ltd.,7,23,3,26
71,1196500,Party Arena: Board Game Battler,0,False,Funture Games,7,16,4,20
72,1196520,The Secret of Hutton Grammar School,0,False,Tom Simpson,0,4,2,6
73,1196550,Days Gone By,0,False,Fineam Neo Studio,0,1,0,1
74,1196570,Suzunaan on Fire,0,False,The Creator Workgroup,0,2,1,3
75,1196580,The Pale City,0,False,Kyle Muntz,0,6,0,6
76,1196630,Nexomon: Extinction,0,False,VEWO Interactive Inc.,8,627,71,698
77,1196690,OctaFight,0,False,Pixel Almost Perfect,0,1,0,1
78,1195910,Dead Dreams,0,False,Aiaz Marx,7,21,1,22
79,1195920,Solar Panic: Utter Distress,0,False,Barracuda Disaster,7,12,3,15
80,1195980,Noble Woman's Pastries,0,False,Aphrodite,0,1,0,1
81,1196080,Space Simulation Toolkit,0,False,Pavel Kudinov,7,33,4,37
82,1196130,Top Run,0,False,Katata Games,0,3,0,3
83,1196160,British Gangsters,0,False,Blackpixel Studio,0,1,2,3
84,1196170,Gang District,0,False,MasterdniM,0,4,0,4
85,1196190,KUMO The Little Robot,0,False,YukiOstudio,0,1,1,2
86,1195530,The Tawashi,0,False,MUTOYS,0,9,0,9
87,1195550,Gamedev simulator,0,False,High and Wide,0,0,2,2
88,1195560,Alek - The Lost Kingdom,0,False,Jessy Lemieux,8,77,18,95
89,1195570,Dark Invasion VR,0,False,Vadim Silver,0,2,0,2
90,1195620,Ocean Drive Challenge Remastered,0,False,Hyo Software,0,2,0,2
91,1195710,Monster Viator,0,False,"Hit-Point Co.,Ltd.",0,4,0,4
92,1195870,零界战线,0,False,Elementman Technology,0,1,0,1
93,1195230,Darkness and Flame: Enemy in Reflection,0,False,FIVE-BN GAMES,7,19,0,19
94,1195270,iFAction Game Maker,0,False,iFAction Studio,7,17,2,19
95,1195320,Mokoko,0,False,NAISU,7,39,0,39
96,1195350,Your little story: Winter,0,False,BananaChu Team,0,3,1,4
97,1195360,Re:Turn - One Way Trip,16,False,Red Ego Games,6,30,10,40
98,1195410,Trial of the Gods: Siralim CCG,0,False,Thylacine Studios,7,20,2,22
99,1195430,Fight High,0,False,Broodling Studios,0,4,0,4
100,1195460,Last Year,0,False,Elastic Games,5,1355,708,2063
101,1194910,Celestial,0,False,Caboose,0,3,0,3
102,1194940,Tower of Shades,0,False,Lame Jam,7,13,3,16
103,1195020,Guardians of the Ashes,0,False,Mature Games,6,82,21,103
104,1195090,Hippoboar Rancher ~かばいの牧場物語~,0,False,OTUSUN LAND,0,1,0,1
105,1195140,URG,0,False,Jani Penttinen,0,2,0,2
106,1195170,Rebound Ball,0,False,meokigame,0,2,2,4
107,1194480,Cursed Gem,0,True,AikonCWD,7,11,0,11
108,1194590,Star Dynasties,0,False,Pawley Games,6,72,26,98
109,1194600,Bronze Hoof,0,True,Persic Games,0,1,0,1
110,1194610,Knights of the Temple: Infernal Crusade,0,False,Starbreeze Studios,7,11,2,13
111,1194630,The Dark Pictures Anthology: Little Hope,18,False,Supermassive Games,6,943,390,1333
112,1194650,ReFrame,0,False,Frame,0,0,1,1
113,1194670,Fairyfail,0,False,Teraknights,0,2,0,2
114,1194680,ZooKeeper Simulator,0,False,Forceight,8,100,12,112
115,1194690,Creatry — Easy Game Maker & Game Builder App,0,False,Sanya,0,1,6,7
116,1194700,House Flipper VR,0,False,Frozen Way,5,59,43,102
117,1194720,No School No Rules,0,False,Namion Games,0,2,1,3
118,1194790,Kessler Effect,0,False,Impulse Machine,0,4,4,8
119,1194830,Master Bladesmith,0,False,Elixir Games,8,186,18,204
120,1194840,Frog Fractions: Game of the Decade Edition,0,True,"Twinbeard, Inc.",8,65,0,65
121,1193990,Trapped,0,False,N4bA,7,11,2,13
122,1194050,Orange Cast: Sci-Fi Space Action Game,0,False,Team Rez,6,36,14,50
123,1194100,Musical Aim Trainer,0,False,Atom studio,0,0,1,1
124,1194140,Blind Justice,0,False,Nicholas Rizzo,5,20,15,35
125,1194160,One-Eyed Lee and the Dinner Party,0,False,DarkChibiShadow,0,5,0,5
126,1194170,Foe Frenzy,0,False,Ellpeck,0,1,0,1
127,1194220,Zombie Tag Royale,0,False,TagYourItGaming,0,2,0,2
128,1194380,Volleyball Fever Flat,0,False,Neuston AB,0,1,0,1
129,1194390,The Land of Crows,0,True,Gemlore,0,4,0,4
130,1193660,Jack-O-Lantern Covers of Darkness,0,False,"Strawberry Game Studios, LLC",0,3,0,3
131,1193730,Piece Of Mind,0,False,Rig Studio,0,0,2,2
132,1193780,Tower Climb,0,False,11Sheep,0,2,0,2
133,1193790,UNHERD,0,False,Happimal,0,4,1,5
134,1193830,Jeremiah,0,False,Tom Wagner - Dubya Studios,0,1,0,1
135,1193930,Ping Pong Space - Retro Tennis,0,False,Best Friend Games,0,2,0,2
136,1193950,Dashbot Ninja,0,False,Trio Queue,0,1,0,1
137,1193110,Love love demon ji-恋恋妖姬,0,False,FlyBoyStudio,0,2,1,3
138,1193160,Bomber Fox,0,False,Laughing Fox Games,0,0,1,1
139,1193200,K37-D,0,False,ShadowBlade Games,0,3,0,3
140,1193210,Hunt the Muglump,0,False,Play Old School Games,0,3,0,3
141,1193300,Axe Cop,0,False,Red Triangle Games,0,7,0,7
142,1193330,Together - A Wish No One Remembers,0,False,Hangover Cat Purrroduction,0,5,0,5
143,1193340,Zelter,0,False,G1 Playground,6,240,65,305
144,1193420,The Dis-United States Of America,0,False,Spaghetti Code Ltd,0,1,0,1
145,1193450,Stripper Anya: Christmas Special,0,False,"X-MiGuPLAY, LLC",0,0,1,1
146,1193460,Bunny Sudoku,0,False,DillyFrame,0,3,1,4
147,1193490,A Crooked Heart,0,False,Little Blackbird Studio,0,2,0,2
148,1193520,Space Climber,0,False,Ferulox Studios,0,1,1,2
149,1193560,Roast Party,0,False,Fraccas,0,6,0,6
150,1192580,Nyanco Dream,0,False,Nyanco Channel,6,10,3,13
151,1192610,ANIME REDEMPTION,0,False,Konnichiwa Games,8,132,30,162
152,1192640,Hentai Mosaique Neko Waifus,0,False,Lil Hentai Games,8,394,21,415
153,1192730,ADULT SHERIFF,0,False,Konnichiwa Games,5,44,23,67
154,1192740,Woman's body: For adults 2,0,False,Softened Cookie,0,3,1,4
155,1192840,The Shenanigans of Cherry and Trix,0,False,Critoniuum,0,1,0,1
156,1192860,Winter Snow | 冬雪,0,False,木子工坊,0,1,0,1
157,1192880,Nostalgiarian,0,False,Cloaz Studio,0,0,1,1
158,1192890,Shoot Them,0,False,Cтрельба,5,16,7,23
159,1192910,食用系少女：美食內戰 Food Girls：Civil War,0,False,SimonCreative,0,2,0,2
160,1192070,TriangleStorm,0,False,Benjamin Berglund,0,1,0,1
161,1192160,Section Six,0,False,Lepus Games,0,1,0,1
162,1192260,Labyrinths of the World: The Wild Side Collector's Edition,0,False,Domini Games,0,3,0,3
163,1192270,Royal Detective: The Last Charm Collector's Edition,0,False,Elephant Games,0,1,0,1
164,1192310,KAWAII GIRLS PUZZLE,0,False,Elementarium games,7,8,2,10
165,1192390,Invisible Enemy,0,False,Studio Cute,0,0,3,3
166,1192410,Room Escape '1053',0,False,Godam Inc.,0,0,1,1
167,1192420,Shuttle Commander,0,False,Immersive VR Education,5,10,9,19
168,1192500,GraFi Christmas,0,False,Blender Games,0,1,1,2
169,1191580,Nexomon,0,False,VEWO Interactive Inc.,8,395,37,432
170,1191590,End of War 1945,0,False,The 45th Division,7,9,2,11
171,1191610,Memory,0,False,Soft Paw Studio,0,1,0,1
172,1191790,The World Is Ruled According to Sexual Prowess So I’m Playing Dirty to Get My Harem Episode 1,0,False,Boom! Boom! Douga,0,2,2,4
173,1191820,Spot The Differences 2020 | 大家来找茬 2020,0,False,KUWOGame,0,3,0,3
174,1191860,Memody: Sindrel Song,0,False,Tobias Cornwall,7,15,0,15
175,1191900,Say No! More,0,False,Studio Fizbin,8,187,12,199
176,1191940,Deathtrap Dungeon: The Interactive Video Adventure,0,False,Branching Narrative Ltd,8,105,8,113
177,1192060,Virus L,0,False,Luthor Dynamics,0,0,3,3
178,1191190,War Robots: Planet Defender,0,False,Xue Dong,0,3,0,3
179,1191210,Seek Girl Ⅲ,0,False,DSGame,8,202,46,248
180,1191280,12 Labours of Hercules X: Greed for Speed,0,False,Jetdogs Studios,0,4,3,7
181,1191440,Forgotten Ways,0,False,IllSeeYou,0,1,1,2
182,1191500,Spire of Sorcery (Limited Early Access),0,False,Charlie Oscar Lima Tango Interactive Entertainment,5,6,9,15
183,1191510,PixHunter,0,False,Studio Inward,0,0,1,1
184,1190620,Defence War,0,False,StarSystemStudios,0,2,5,7
185,1190640,Memory Match Saga,0,False,Boogygames Studios,0,1,0,1
186,1190750,GameAssistant: The Tool For Every Gamer,0,True,GameAssistant Team,0,0,1,1
187,1190760,Tales of the Deck,0,False,One Bit Factory,0,0,3,3
188,1190780,DooM in the Dark 2,0,False,indie_games_studio,0,0,2,2
189,1190810,Ghetto Conspiracy,0,False,Ghetto Games,0,8,0,8
190,1190820,Booobjz,0,False,FreeAnimals_Software,0,6,0,6
191,1190910,Defend Them !,0,False,Butter Fly Games,0,1,0,1
192,1190930,ScribbleDude,0,False,RandomErik,0,6,0,6
193,1190980,Hoarding Simulator,0,False,Ryan Carlos,0,0,1,1
194,1191070,Yuki Onna | 雪女,0,False,Chilla's Art,6,35,11,46
195,1191100,Hentai Waifu,0,False,GentleDriver,6,13,4,17
196,1190160,LIT: Bend the Light,0,False,Copperglass,8,81,5,86
197,1190180,Arrow,0,True,HEILAH,0,1,0,1
198,1190310,Dancing Arrow : Beat Smash,0,False,Geniesoft Inc.,0,2,0,2
199,1190380,Race Race Racer,0,False,Enaayah Software Development and Services Private Limited,6,8,3,11
200,1190400,The Wonderful 101: Remastered,0,False,PlatinumGames Inc.,8,196,35,231
201,1190410,Crazy city,0,False,JOJO,0,2,1,3
202,1190460,DEATH STRANDING,0,False,KOJIMA PRODUCTIONS,8,13612,1329,14941
203,1190480,Heebie Jeebies: The Roller Coaster,0,False,Lukas Litinskas,0,1,1,2
204,1190560,Scriptum VR: The Neighbor's House Escape Room,0,False,Adver2Play,0,1,0,1
205,1189740,Juken Jigoku | 受験地獄,0,False,W&H Game Systems,5,11,5,16
206,1189750,WinTweaker,0,False,Giga-Core,0,4,2,6
207,1189780,Wallachia: Reign of Dracula,0,False,Migami Games,6,31,9,40
208,1189800,Bleeding Edge,0,False,Ninja Theory,6,525,224,749
209,1190060,The Last Deathbound,0,False,Kenny Doan,0,4,0,4
210,1190110,H-SNIPER: Middle East,0,False,Konnichiwa Games,8,355,32,387
211,1190120,Good doktor,0,False,Niko Belik,0,1,4,5
212,1189230,Door in the Woods,0,False,teedoubleuGAMES,6,116,35,151
213,1189360,Art of Beauties,0,False,Kotovodk Studio,7,9,2,11
214,1189380,Beat Or Die The MiniGames,0,False,BlueNothing Games,0,1,0,1
215,1189440,VenusBlood FRONTIER International,0,False,Ninetail,7,24,5,29
216,1189460,ClickCells: Office Lady,0,False,Crew Lab,6,15,5,20
217,1189520,Street Hoop,0,False,Digicon,0,4,1,5
218,1189630,Path Of Wuxia,0,False,Heluo Studio,8,474,28,502
219,1189650,Post Scriptum CTG: Collectible Token Game,0,True,Alien Intelligence UAB,0,1,1,2
220,1188760,JEF,0,False,Jeremy Couillard,7,37,3,40
221,1188800,In the Service of Mrs. Claus,0,False,Choice of Games,0,2,2,4
222,1188970,Ether Loop,0,False,Moon Lens,6,89,25,114
223,1188990,WREST,0,False,Shaftesbury Lucid Inc,6,8,3,11
224,1189020,LOGA: Unexpected Adventure,0,False,Ibrahim sofan,0,0,2,2
225,1189040,Smart Girl : Christmas,0,False,Smart Party,0,0,1,1
226,1189050,Hot And Lovely,0,False,Lovely Games,5,13,8,21
227,1189080,Squirrel Legacy,0,False,Obscure,0,3,3,6
228,1189120,Posibility,0,False,UGtobest,0,0,1,1
229,1189200,Moonlight Basket,0,False,Inu to Neko,0,1,0,1
230,1189210,Yuna and other troubles,0,False,Strawberry Entertainment,0,0,1,1
231,1188430,"Deep, In the  Forest",0,False,Satur Entertainment,5,8,6,14
232,1188540,Apex Aim Trainer,0,False,SharkFishFish,8,96,15,111
233,1188580,Classic Snake Adventures,0,False,Crazysoft Limited,0,2,0,2
234,1188670,Castle Commander,0,False,Barry McCabe,0,1,0,1
235,1188680,The Political Machine 2020,0,False,Stardock Entertainment,8,442,98,540
236,1188690,Speed Masters ASD,0,False,H.D.A.,0,1,0,1
237,1188710,Bloodholic,0,False,釉里红,0,1,0,1
238,1188000,Pulstario,0,False,Fred Wood,7,15,0,15
239,1188060,My hot beach vacation,0,False,Ero Team Triangle,0,1,2,3
240,1188080,Cats are Liquid - A Better Place,0,False,Last Quarter Studios,8,73,5,78
241,1188140,Country Road VR,0,False,Somun Immersive,0,5,1,6
242,1188160,Ground Zero Texas - Nuclear Edition,0,False,Screaming Villains,0,3,3,6
243,1188250,GLOWCOMA: chapter 1,18,False,Tsvetomir Georgiev,8,74,9,83
244,1188260,Creature Card Idle,0,False,Fordesoft,5,37,20,57
245,1188280,Coffee Rush,0,False,Anarchy Enterprises,0,1,0,1
246,1188290,Cover Your Eyes,0,False,StarSkipp,0,0,1,1
247,1188310,Mini Island,0,False,MACKINN7,0,5,0,5
248,1188330,Classic Sudoku,0,False,Studio Goya,8,205,17,222
249,1187600,Wicked Willow,0,False,T.F. Wright,7,23,4,27
250,1187620,Hentai Pazu,0,False,GentleDriver,5,9,4,13
251,1187650,Blaze Revolutions,0,False,Little Chicken Game Company,0,5,1,6
252,1187740,InfiniteBeat,0,False,CyberGods,0,2,3,5
253,1187790,FULLCHOKE : Clay Shooting VR,0,False,ROLLINGJ GAMES,0,5,2,7
254,1187830,Incredible Dracula: Witches' Curse,0,False,Platinum Games,0,2,0,2
255,1187840,Vesper,0,False,Cordens Interactive,0,4,0,4
256,1187900,NARWHAR Project Hornwhale,0,False,AB,0,1,0,1
257,1187940,Is It Wrong to Try to Pick Up Girls in a Dungeon? Infinite Combate,0,False,MAGES. Inc.,4,28,45,73
258,1187950,Gaijin Charenji 1 : Kiss or Kill,0,False,overGame Studio,0,1,0,1
259,1187330,Tower Tag,0,False,VR Nerds,8,96,16,112
260,1187420,Hasfax,0,False,HorseGames,0,3,5,8
261,1187430,"SpaceVibes VR (Point & Click, Abstract, Disco Music)",0,False,vrSimilitude (Karrson Heumann),0,0,1,1
262,1187490,Phoenix Tales,0,False,Adventurers Guild Entertainment,0,3,1,4
263,1187510,Rock Simulator,0,False,Vinoo,8,155,6,161
264,1186880,OctoFurry,0,False,ArenaDev,7,38,6,44
265,1186940,Underneath,0,False,NORSKA,0,0,1,1
266,1187030,星礼研究所 | Sighchology Research Lab,0,False,Kalaicoconut Studio,0,0,2,2
267,1187110,INVESTMENT HERO,0,False,SexyPolygonGames,0,1,1,2
268,1187140,Elementary Anatomy: With Story Mode,0,False,Virtual Medicine,0,4,0,4
269,1187190,The Knight of the Crimson Tower,0,False,Ikuku,0,2,0,2
270,1187250,Consumed Awakening,0,False,Birchislet Gaming,0,1,0,1
271,1186400,West Sweety,0,False,ADOG,6,111,35,146
272,1186460,Songs Of Wuxia,0,False,苏州幻步网络科技有限公司,0,5,3,8
273,1186510,Land of Ngoto,0,False,Marc Oesigmann,0,1,1,2
274,1186530,Business Wars - The Card Game,0,False,Black Phoenix Studio,0,2,1,3
275,1186570,Die Fantastischen VR - Fantaventura,0,False,gebrueder beetz filmproduktion,0,2,0,2
276,1186580,New York Mysteries: The Outbreak,0,False,FIVE-BN GAMES,7,16,2,18
277,1186630,1971 PROJECT HELIOS,0,False,Recotechnology S.L.,0,1,2,3
278,1186640,Pumpkin Jack,0,False,Nicolas Meyssonnier,9,1044,53,1097
279,1186650,MADELA,0,False,Habib Alejalil,0,0,3,3
280,1186690,Timpu's treasure,0,False,Siddharth Sivaraman,0,2,0,2
281,1186720,The Cruxis Sword,0,False,Daydream Studios,0,2,1,3
282,1186730,Terro Lunkka Adventures,0,False,Tero Lunkka,0,1,0,1
283,1186740,Kyle is Famous,0,True,John Szymanski,0,2,0,2
284,1186770,Disgrâce,0,False,Bladiriel,0,0,1,1
285,1186100,Beast Brigade,0,False,David Valentine,0,4,1,5
286,1186160,All Day Dying: Redux Edition,0,False,Paulo Lopes,7,21,5,26
287,1186220,Wire Lips,0,False,AIHASTO,7,22,1,23
288,1186260,Bondage Girl,0,False,MCG,5,8,9,17
289,1186270,Nosferatu Lilinor,0,False,neon,0,2,0,2
290,1186280,Dodge If you Can!,0,False,Andrew H.P. Lee,0,2,0,2
291,1186290,Ballance: The Return,0,False,"Happy Happy Technology Chengdu Co., Ltd.",0,2,7,9
292,1186310,Mailbox,0,False,S'Games,0,1,1,2
293,1186340,Action Ball 2,0,False,Rionix,0,6,0,6
294,1186350,Lethal Tempting Girls,0,False,Soil Hammer Studio,0,2,0,2
295,1185600,神国：创造（The Kingdom of God）,0,False,明枭网络,0,0,1,1
296,1185620,NecroLand : Undead Corps,0,False,JANUS LABS,0,0,1,1
297,1185630,CubeParkour,0,False,Pit Forest,0,2,0,2
298,1185660,Sex Adventure - The Board Game,0,False,CritoGames,0,5,1,6
299,1185700,Arrog,0,False,LEAP Game Studios,7,27,4,31
300,1185730,Lovely Hentai,0,False,Snkl Studio,0,5,1,6
301,1185740,Mira,0,False,Too Husky,0,4,1,5
302,1185820,Hollow Island,0,False,Edym Pixels,8,46,6,52
303,1185870,Skyland 1976,0,False,Simon CLAVEL,6,11,3,14
304,1185950,Wars of the Roses,0,False,HexWar Games,0,6,2,8
305,1185960,Napoleon in Russia,0,False,HexWar Games,0,2,0,2
306,1186030,Death Park,0,False,Euphoria Games,7,9,1,10
307,1186040,Worms Rumble,0,False,Team17 Digital,6,364,101,465
308,1185330,Blades of Gory,0,False,Fortcullis Games,5,7,4,11
309,1185360,Alan Sharp,0,False,Mystive Studios,7,24,3,27
310,1185390,How to Become a Ninja: Part 1,0,False,Pixel vs Pixel,0,1,0,1
311,1185410,Minigame Blast,0,False,Northern Amusements,0,1,0,1
312,1185470,Deathbloom: Chapter 2,0,False,Vincent Lade,7,12,2,14
313,1185480,Doom of the Clawn,0,False,1scGames,0,4,0,4
314,1185520,Love Rhythm,0,False,Triple-S,8,120,27,147
315,1185560,Astellia,0,False,Studio 8,5,363,193,556
316,1184960,Escalation: Aggressors,0,False,Hubert Dzikuć,7,10,1,11
317,1184980,The Explorer,16,False,SedSanGames,0,0,1,1
318,1184990,Huuma Mina: The Secret of Immortality,0,False,Hajime Doujin Circle,8,60,5,65
319,1185000,Bloody trains,0,False,Marginal act,0,2,2,4
320,1185140,The Golden Cross,0,False,Jam Entertainment,0,3,0,3
321,1185160,Inunaki Tunnel | 犬鳴トンネル,0,False,Chilla's Art,8,76,18,94
322,1185270,经典扫雷,0,False,koyomogi,0,0,1,1
323,1185280,The Innkeeper,0,False,Game Brewery,0,3,0,3
324,1184450,Magic of Autumn,0,False,Small Moons,7,18,0,18
325,1184470,ASTROPUPPA,18,False,Dev.Id Games,0,1,0,1
326,1184500,YUKI,0,False,ARVORE Immersive Experiences,7,17,0,17
327,1184550,TERMINAL VR,0,False,REMANIC,5,9,4,13
328,1184570,Last Neighbor,0,False,TrerPlay,0,3,2,5
329,1184700,Whispered Secrets: Dreadful Beauty Collector's Edition,0,False,Grandma Studios,0,1,0,1
330,1184720,Later,0,False,Little Thingie,0,1,0,1
331,1184770,The Political Process,0,False,Verlumino Studios LLC,9,944,36,980
332,1184780,BOTS,0,False,KeyWheel,0,3,0,3
333,1184820,Poker Quest,0,False,Playsaurus,8,94,6,100
334,1184840,Chaos Galaxy,0,False,Han Zhiyu,8,65,8,73
335,1184880,Puzzle Girls,0,False,ATMCLOUD Games,0,4,1,5
336,1184890,Fleeting Iris,0,False,Heaven Studios,6,14,4,18
337,1184900,Unitied,0,False,Peter Hijma,7,19,0,19
338,1184040,D1896,0,False,Arkhouse Telegraph,0,6,2,8
339,1184050,Gears Tactics,18,False,Splash Damage,8,1635,393,2028
340,1184070,Overrun,0,False,Total Involve,0,0,1,1
341,1184090,Belly Dance Girl,0,False,Running Hoffman,0,4,4,8
342,1184160,RUSSIAPHOBIA,0,False,European Flameworms,6,382,146,528
343,1184190,Knockout Bowling VR,0,False,Zvky design studio,0,0,1,1
344,1184230,Cross Border VR,0,False,KR,0,1,2,3
345,1184260,Warchasm,0,False,Defective Penguin Games,0,2,0,2
346,1184310,Slippery Sausage,0,False,Wonderthing,0,2,0,2
347,1184400,Succubus Waifu,0,False,永恆艾莉絲工坊,5,16,12,28
348,1184420,天降锦鲤 ~ My Lucky Koi,0,False,V.P. TEAM,0,2,0,2
349,1183470,Imperiums: Greek Wars,0,False,Kube Games,8,76,7,83
350,1183480,Bonsai Castles,0,False,Hyakuren Soft,0,3,0,3
351,1183500,Puppy Cross,0,False,DIMANCHE CORP.,7,32,2,34
352,1183510,Little Town Hero,0,False,GAME FREAK inc.,0,3,4,7
353,1183580,Terra Alia: The Language Learning RPG,0,False,30 Parallel,7,8,2,10
354,1183670,Angry Zombies,0,False,Studio Inward,0,7,1,8
355,1183720,Holoswitch,0,False,triple A code GmbH,8,70,14,84
356,1183840,Dungeon of Rikka,0,False,Poorly Drawn Squid,7,10,1,11
357,1183030,Layers of Fear VR,16,False,Incuvo S.A.,6,61,21,82
358,1183080,MMA President,0,False,Sim World Games,5,8,5,13
359,1183140,Planet Lander,0,False,NanningsGames,0,4,0,4
360,1183170,All World Pro Wrestling,0,False,Heart's Choice,7,12,1,13
361,1183200,Portal Dogs,0,False,Brain Connected,0,2,0,2
362,1183210,Through The Unknown,0,False,Cozy Cloud Productions,0,2,0,2
363,1183230,A Pirate's Pleasure,0,False,Heart's Choice,0,5,1,6
364,1183240,Image Compressor,0,False,Software Utility,0,5,2,7
365,1183260,TrymenT ―Ima o Kaetai to Negau Anata e― AlphA,0,False,TrymenT,0,7,0,7
366,1183280,Jazz Age,0,False,Heart's Choice,0,3,2,5
367,1183300,Dawnfall,0,False,Heart's Choice,0,5,2,7
368,1183410,you are pig sitter,0,False,yukitama,0,1,0,1
369,1183420,Monochrome World,0,False,RAREST,0,1,0,1
370,1182670,Haunted Hotel: Room 18 Collector's Edition,0,False,Elephant Games,0,6,2,8
371,1182690,A Dark World: The Glowing City,0,False,Kipsaim(Mike) Delgado,0,0,1,1
372,1182720,GO-4-Soldier-1,0,False,ARMSCor Studios,0,2,0,2
373,1182760,Starlight,0,False,Bambuseae Games,5,17,13,30
374,1182770,Caves and Castles: Underworld,0,False,Amegami,0,3,0,3
375,1182830,QT,0,False,Happy Snake,8,102,3,105
376,1182890,Dunmakia Kingdom,0,False,Pelle Niklas Abrahamsson,0,1,0,1
377,1182920,Movavi Video Editor Plus 2020 - Video Editing Software,0,False,Movavi Software,8,180,29,209
378,1182970,VR Katherine,0,False,VR Katherine,5,7,10,17
379,1182280,Foodtruck Arena,0,False,Cat-astrophe Games,0,1,0,1
380,1182470,reky,0,False,beyondthosehills,7,19,1,20
381,1181790,Circle of Sumo: Online Rumble!,0,True,Yonder,0,3,0,3
382,1181820,Colossal Saga,0,False,Paraverse Games,0,0,1,1
383,1181840,HIVESWAP: ACT 2,0,False,"What Pumpkin Games, Inc.",8,535,71,606
384,1181880,Draconic Echoes: The Ardent War,0,False,Mark Vanderploeg,0,1,0,1
385,1181910,Halloween Chronicles: Evil Behind a Mask Collector's Edition,0,False,Domini Games,0,5,0,5
386,1182020,WGT Golf,0,True,Topgolf Media,0,4,0,4
387,1182090,Mr. Pumpkin 2: Kowloon walled city,0,False,Cotton Game,0,9,0,9
388,1182110,Weed Shop 3,0,False,Weed Games,8,267,30,297
389,1182200,Hidden World of Art 2,0,False,Meridian93 Studio,0,5,2,7
390,1181330,D3D INSIDE,0,False,Oblom studio,0,5,2,7
391,1181400,Path of Giants,0,False,Journey Bound Games,8,92,1,93
392,1181440,ToGather:Island,0,False,Studio Kamii,7,32,7,39
393,1181470,My Haunted Doll,0,False,Anamik Majumdar,0,3,2,5
394,1181510,OS Omega,0,False,Artur Mandas,0,1,0,1
395,1181520,Null & Peta -Invasion of the Queen Bug-,0,False,TOKYOTOON,7,13,3,16
396,1181570,Feria d'Arles,0,False,Tom Simpson,7,37,1,38
397,1181600,Jetboard Joust,0,False,BitBull Ltd,7,15,2,17
398,1181750,THE VR CANYON,0,False,Wild Monkeygames,0,1,1,2
399,1180820,Escape!,0,False,Sapphire Create.,0,0,1,1
400,1180900,Winter War,0,False,The Strategy Game Studio,7,18,1,19
401,1180940,Spellinkers,0,False,PixLuna Game Studio,0,2,1,3
402,1180960,Arktrum,0,False,Square Gem Software,0,0,1,1
403,1180970,Phantom Path,0,False,KEYREAL,0,7,1,8
404,1181000,UBERMOSH:OMEGA,0,False,Walter Machado,8,65,2,67
405,1181020,Squillamorph,0,False,Barrow Studios Ltd,0,1,2,3
406,1181030,Forest Guardian,0,False,TsukiWare,7,21,2,23
407,1181070,BOX,0,False,Elzai Games,0,1,0,1
408,1181120,Picture toys,0,False,lvfo,0,4,2,6
409,1181130,Play with NEKO,0,False,Cyber Keks,6,10,4,14
410,1181220,aMAZE Gears 2,0,False,Blender Games,0,5,0,5
411,1181270,God of Gym,0,False,Team KARPETTI,0,6,3,9
412,1181280,EBONY,0,False,indie_games_studio,0,2,2,4
413,1181290,Aria Dating Simulator,0,False,Dominic Wilson,0,1,2,3
414,1180370,Wienne,0,True,Creeepling,0,2,0,2
415,1180420,Windmill Kings,0,False,Bigosaur,0,3,1,4
416,1180450,Exitium,0,False,Exquisite Games,0,2,1,3
417,1180540,Puddle Knights,0,False,Lockpickle,8,59,1,60
418,1180550,Little Witch  Luana,0,False,Del_Player,0,1,1,2
419,1180560,Abelana's Atom Maker,0,False,Abelana VR,0,2,0,2
420,1180610,Npc Problems: Vertex Coloring,0,False,Fractal Projects,7,11,0,11
421,1180620,Bullet Beat: Musical Shoot'em up,0,False,TERNOX,0,6,2,8
422,1180650,Bakemono - Demon Brigade Tenmen Unit 01,0,False,SuperSane Games,0,6,1,7
423,1180690,Spaceman,0,False,Conmtrast,0,1,2,3
424,1180700,Shooting Star,0,False,Studio Inward,0,2,0,2
425,1179880,Maverick,0,False,Prime2Gold,0,1,0,1
426,1180000,I Will Be Your Eyes,0,False,Jake Johnson,0,1,0,1
427,1180070,Bangers & Mash,0,False,Chiodo,0,1,0,1
428,1180110,DeadShotZ,0,False,IndigoWare,7,11,0,11
429,1180190,Call of VII,0,False,Trevor Alex,0,2,1,3
430,1180250,DIVINATION,0,False,Mojiken,8,43,7,50
431,1180270,Forbidden Love With The Ghost Girl,0,False,Long Wing Studio,7,15,3,18
432,1180330,Manor of Mystic Courtesans,0,False,Nine’s Graphics,6,39,10,49
433,1179540,Sweet Thomas,0,False,Dnovel,0,4,0,4
434,1179560,Gachi Heroes 2: Flexboll,0,False,Lohsoft,7,31,5,36
435,1179570,Jazz Lightning : Castle Dungeons,0,False,Kappa Bits,0,3,0,3
436,1179620,Journey of the Broken Circle,0,False,Lovable Hat Cult,0,9,0,9
437,1179790,Heroes Of Maidan 3: Crimean Battle,0,False,LuftWaffel,0,1,0,1
438,1179840,Origin,0,False,Carcosa,0,0,1,1
439,1179170,Super Angling,0,False,"Instance Entertainment, LLC",0,1,0,1
440,1179190,Dinodrifters,0,False,Jake Hugh Reece Wilson,0,1,0,1
441,1179210,Kill It With Fire,0,False,Casey Donnellan Games LLC,9,767,27,794
442,1179300,Quicken WillMaker & Trust 2020,0,False,Nolo,0,2,0,2
443,1179340,Kōmori Fruit Rush,0,False,Lone Rogue Productions,0,1,0,1
444,1179390,Victorian Admirals Caroline Crisis 1885,0,False,Totem Games,0,1,1,2
445,1179410,Lootcraft,0,False,EricSchmitt,0,5,3,8
446,1179420,Brunswick Pro Billiards,0,False,"Farsight Studios, Inc.",0,3,3,6
447,1179460,HAM-MASTER,0,False,STUDIOS MAGMA,7,10,0,10
448,1179500,Star Gods,0,False,JOP Studios,0,2,0,2
449,1178880,Panzer Dragoon: Remake,0,False,MegaPixel Studio S. A.,8,158,33,191
450,1179060,Wing of Darkness,0,False,Production Exabilities,5,6,4,10
451,1178380,Resurrector,0,False,GSGame,0,1,2,3
452,1178400,Pro Cycling Manager 2020,0,False,Cyanide Studio,6,71,25,96
453,1178430,Summer Games Heroes,0,True,Olivier Monaret,0,1,0,1
454,1178460,Desktop Portal,0,False,CircuitLord,7,36,6,42
455,1178480,Space Station Invader VR,0,False,TesseraktZero,0,0,1,1
456,1178500,Crazy Eights 3D Premium,0,False,BufoProject,0,3,1,4
457,1178510,Gin Rummy 3D Premium,0,False,BufoProject,0,2,3,5
458,1178570,Dissection Simulator: Feline Edition,0,False,VictoryXR,0,0,1,1
459,1178680,RetroVamp,0,False,DavideJ,0,9,0,9
460,1178690,Hyper-Casual Hentai,0,False,Sinful Sloth,0,0,1,1
461,1178710,The Legend of Arcadieu,0,False,Kavorkaplay,0,0,3,3
462,1178780,BattleGroupVR,0,False,SpaceOwl Games,8,373,31,404
463,1178790,Shiren the Wanderer: The Tower of Fortune and the Dice of Fate,0,False,"Spike Chunsoft Co., Ltd.",6,68,22,90
464,1177890,Cave of Illusions,0,False,Vidas Salavejus,6,12,5,17
465,1177950,Craft Elements,0,False,PolincGames,0,0,1,1
466,1177990,Welcome to Primrose Lake,0,False,SQRT3,6,8,3,11
467,1178000,Ghost Dimension,0,False,Saulo Rosart,0,9,0,9
468,1178020,Shot the Body,0,False,Medic-Games,0,0,2,2
469,1178060,Spooky Night 2,0,False,Aureal Studio,0,0,1,1
470,1178120,XP Girls,0,False,OneShark,7,28,6,34
471,1178140,Pixel Ripped 1995,0,False,ARVORE Immersive Experiences,8,83,1,84
472,1178150,MazM: Jekyll and Hyde,0,False,Growing Seeds,7,11,0,11
473,1178180,BATYA,0,False,OKONNAYA RAMA,0,3,1,4
474,1178200,Somewhere inside,0,False,Funny Games,6,14,5,19
475,1178210,Stirring Abyss,0,False,Sleepy Sentry,8,77,12,89
476,1178220,ICBM,0,False,SoftWarWare,8,469,27,496
477,1178280,Ultimate Visualizer,0,False,UltimateDesktop,4,5,20,25
478,1178290,Dezatopia,0,False,HEY,7,14,0,14
479,1178310,Picross.io,0,False,Alexander Mirgorod,0,2,2,4
480,1178330,名媛女友-Girlfriend invites,0,False,Flyboy,0,2,0,2
481,1177660,Escape the Ayuwoki,0,False,Deadlycrow Games,8,182,45,227
482,1177690,The Summoning,0,False,Randumb Studios,6,32,13,45
483,1177720,Yu Escape / Monday,0,True,Team Tailnut,0,8,1,9
484,1177810,Stream Fighters,0,False,Cringe Engine Studio,0,1,2,3
485,1177850,Deadly Night - No Escape,0,False,SilverDam™,0,1,0,1
486,1177350,Molly: fear of clowns,0,False,BA.D,0,0,1,1
487,1177400,江湖余生：缘起,0,False,柚子丁工作室,0,4,0,4
488,1177420,邻居大叔/UncleNeighbor:uncle Dating Simulator,0,False,GameUncle,8,219,13,232
489,1177460,Dangerous Blaster,0,False,Juicy Frog,0,1,0,1
490,1177510,GASH,0,False,Jaden Duchene,0,1,0,1
491,1177610,Katana Kata,0,False,Stas Shostak,7,17,3,20
492,1176970,Bolf,0,False,SimTenero,0,2,2,4
493,1176990,VECTORLORD,0,False,NerveQuake Software Inc.,0,6,0,6
494,1177000,TRANSFORMERS: BATTLEGROUNDS,0,False,Coatsink,6,10,3,13
495,1177020,Gigantosaurus The Game,0,False,WildSphere,0,3,1,4
496,1177030,PONG Quest™,0,False,Chequered Ink Ltd.,7,10,2,12
497,1177080,Geometry Hero,0,False,Kyo Soft,0,1,0,1
498,1177110,The Sorrowvirus,0,False,Watchmaker,6,15,4,19
499,1177130,NABOKI,0,False,Maciej Targoni,8,110,4,114
500,1177170,Pooplers,0,False,Art Games Studio S.A.,0,2,3,5
501,1176850,GOOSE.IO,0,False,Ammonite Design Studios Ltd,0,2,1,3
502,1176890,DateJournal: Russian Girls Dating Sim,0,False,penciltape games,0,5,1,6
503,1176440,Math The Question,0,False,Kanchit's Games,0,1,0,1
504,1176460,They Came From a Communist Planet,0,True,Colestia,7,12,2,14
505,1176480,The City of Time,0,False,DY_STUDIO,0,4,1,5
506,1176580,Periodic Deliveries,0,False,The Periodic Group,5,7,5,12
507,1176590,Seek Hearts,0,False,Exe Create Inc.,0,1,0,1
508,1176360,Contract Killers,0,False,Kapi Kapi Games,0,0,3,3
509,1175900,Antares,0,False,Sonaloux Entertainment,0,1,2,3
510,1175930,Ray Eager,0,False,Saivs,0,4,1,5
511,1175950,Cyberpunk Sex Simulator,0,False,Slippy Floor,5,11,8,19
512,1175980,城市生存计划 / City Survival Project,0,False,HAN GUANG,0,1,0,1
513,1176040,"I Have Low Stats But My Class Is ""Leader"", So I Recruited Everyone I Know To Fight The Dark Lord",0,False,Cannibal Interactive,0,2,1,3
514,1176050,秘封旅行 ~ Secret Sealing Travel,0,False,鸽屋谷,0,3,0,3
515,1176160,Space Wars,0,False,High and Wide,7,10,2,12
516,1176170,GIRLS BATTLEGROUNDS | 性感大逃杀,0,False,Rabotiagi games,6,18,5,23
517,1176190,Space Candy,0,False,High and Wide,4,4,7,11
518,1175470,Shine's Adventures 6 (Go! Girls),0,False,ShineProject,0,1,2,3
519,1175480,Shadowrain,0,False,Killed Pixel Games,5,8,4,12
520,1175490,Code Zero,0,False,SergesChateau,0,2,0,2
521,1175500,Jack In Town,0,False,Marius Chatillon,0,0,1,1
522,1175510,Cerberus: Orbital watch,0,False,Evil Castle Entertainment,0,1,1,2
523,1175550,Merge Towers,0,False,Sibling Rivalry Games,0,0,1,1
524,1175590,JAGD LANZER,0,False,leimonya,0,3,1,4
525,1175640,Zombie Road Rider,0,False,Devdan Games,6,11,4,15
526,1175650,UpMove,0,False,Perichron Interactive,0,2,0,2
527,1175720,Gerritory,0,False,Party Goose,0,1,0,1
528,1175830,Legend of Mana,0,False,Square Enix,8,214,51,265
529,1175880,War Room,0,False,Binge Gaming OU,5,155,96,251
530,1174980,Mazetools Mutant,0,False,Stephan Kloss,0,2,0,2
531,1174990,Sushi Pachi Panic,0,False,Kalvin Goodlow,0,1,0,1
532,1175060,Human Simulator,0,False,Lyre Lyre Studios,6,15,4,19
533,1175070,Survived,0,False,NA,0,2,0,2
534,1175080,Easy Bug Manager,0,True,XuDaWang,0,1,0,1
535,1175140,Vecter,0,True,Taranasus,0,2,0,2
536,1175160,House of 1000 Doors: The Palm of Zoroaster,0,False,Five-BN,0,8,0,8
537,1175170,Incredible Dracula: The Ice Kingdom,0,False,Platinum Games,0,1,0,1
538,1175190,Natsuki Chronicles,0,False,Qute,7,16,0,16
539,1175200,Forbidden Ingress,0,False,Strange_Indie_Team,5,44,19,63
540,1175250,Finders Reapers,0,False,MOSQUITO COCKTAIL LTD,7,11,0,11
541,1175360,"I, Dracula: Genesis",0,False,Moregames,8,176,20,196
542,1175390,Ultimate Live Wallpaper,0,False,UltimateDesktop,4,15,37,52
543,1175420,Imbroglio,0,False,Rostislav Pogosian,6,8,3,11
544,1175430,Project Starship X,0,False,Panda Indie Studio,7,31,0,31
545,1174670,Nordic Warriors,0,False,Liron Peer,7,16,0,16
546,1174690,love wish 2,0,False,Double W,8,94,17,111
547,1174720,SwarmZ,0,False,Mutiny Software,5,78,46,124
548,1174780,MONEY LOVES SILENCE,0,False,Vasiliy Sadovyi,0,6,2,8
549,1174810,Curse of the dungeon,0,False,Axe Games,0,0,1,1
550,1174830,The Magician's Workshop,0,False,Choice of Games,0,6,3,9
551,1174860,Tacview,0,True,Raia Software Inc.,7,11,0,11
552,1174890,"No Offence, But",0,False,Maybe Later Games,0,0,1,1
553,1174170,Earthshine,0,False,Elleiv,0,5,0,5
554,1174260,The Lost Cave of the Ozarks,0,False,Rubber Garden,0,1,1,2
555,1174320,Travel Mosaics 10: Spooky Halloween,0,False,Jetdogs Studios,0,5,0,5
556,1174390,ANNIE:Last Hope,0,False,Pixel Rice,8,53,9,62
557,1174400,Togainu no Chi ~Lost Blood~,0,False,Nitroplus,8,80,7,87
558,1174420,Libertad o Muerte!,0,False,Headquarter S.L.,0,5,2,7
559,1174430,Space Shapes,0,False,Almighty Cow,0,1,0,1
560,1174440,A Zone,0,False,LUCKY STAR STUDIO,0,2,0,2
561,1174490,Space Carrot,0,False,1.5 hp games,0,1,0,1
562,1174500,Yuletide Legends: Who Framed Santa Claus,0,False,Brave Giant LTD,7,13,3,16
563,1174550,Bird Simulator,0,False,GameFlare.com,5,15,9,24
564,1173870,Endless Knight,0,False,Will Sykes Games,7,17,1,18
565,1173940,Barrage Musical ~ Basic Danmaku Tutorial ~ / 弹幕音乐绘 ~ 基础教学篇 ~,0,False,SlimeSmile,7,25,1,26
566,1174090,Unicorn Tails,0,False,RavenFist Studios LLC,7,33,2,35
567,1174120,Space Road,0,False,Studio Inward,0,2,0,2
568,1173500,Kira's Contract,0,False,Silver Cloud,0,2,2,4
569,1173510,XSOverlay,0,False,Xiexe,8,193,15,208
570,1173610,MouseWars Party,0,True,[r]labs,0,1,0,1
571,1173630,Beat Rush,0,True,Ongakken s. r. o.,0,1,0,1
572,1173650,SWEET MILF,18,True,cyberworks,0,0,1,1
573,1173700,Kontrol Flow,0,False,Tyler Stansfield Jaggers,0,1,1,2
574,1173730,Hexia,0,False,Black Mastiff Studio,6,9,3,12
575,1173790,FINAL FANTASY III,0,False,Square Enix,8,257,13,270
576,1173830,Coloring Game: Pixel,0,False,L. Stotch,7,45,1,46
577,1173850,Zombie Panic In Wonderland DX,0,False,Akaoni Studio,0,3,0,3
578,1173110,Please adopt me. # AI needs repair.,0,False,creati-bu,0,0,1,1
579,1173120,Markov Alg,0,False,Fewjix,0,7,0,7
580,1173150,Goosebumps Dead of Night,0,False,Cosmic Forces,6,9,3,12
581,1173200,Metal Unit,0,False,JellySnow Studio,8,173,20,193
582,1173230,Zapitalism,0,False,LavaMind,6,7,3,10
583,1173240,Profitania,0,False,LavaMind,0,0,1,1
584,1173250,DE:VOID,0,False,Eggion,0,3,0,3
585,1173260,Gangsta Sniper 3: Final Parody,0,False,Tero Lunkka,0,0,1,1
586,1173270,Big Red Hood: Halloween,0,False,7DOTS,5,9,10,19
587,1173310,Lab 7: Cold Nights,0,False,CaveDave,7,11,1,12
588,1173340,War Trains,0,False,War Trains,0,0,6,6
589,1173350,HENTAI CLIMBER,0,False,PlatSTUDIO,5,30,14,44
590,1173370,Slapshot: Rebound,0,True,Oddshot Games,0,6,0,6
591,1173380,NEKO ARENA,0,False,Neko Cloud,8,328,53,381
592,1173410,My Breast Friend Sally,0,False,Lewd Mewd,5,124,55,179
593,1172620,Sea of Thieves,0,False,Rare Ltd,8,47422,4501,51923
594,1172640,Parcel Panic,0,False,Hernes Hunters Productions,0,1,0,1
595,1172720,Doubles Hard,0,False,Red Dev Studio,0,2,0,2
596,1172760,Twilight's Last Gleaming,0,False,HexWar Games,0,2,1,3
597,1172940,Cockwork Industries Complete,0,False,Digital Seductions,6,259,77,336
598,1173010,Flowers Blooming at the End of Summer,0,False,MidnightWorks,0,5,0,5
599,1172080,Anonymous Player,0,False,Francesco Napoli,0,0,1,1
600,1172150,Blue Boy: Bleeding Out,0,False,Ben Renya,0,5,0,5
601,1172170,Krystopia: A Puzzle Journey,0,False,Antler Interactive,7,22,2,24
602,1172220,Space Space,0,False,Gino Di Pierro,0,1,0,1
603,1172290,ControlRoom,0,False,Persp3ctive,0,1,1,2
604,1172340,Short Scary Stories (Trial Maps),0,False,Lotus GamesTr,0,0,1,1
605,1172380,STAR WARS Jedi: Fallen Order™,0,False,Respawn Entertainment,8,39063,3942,43005
606,1172390,Anime Tanks Arena,0,False,Neko Cloud,5,18,9,27
607,1172410,Rage Among The Stars,0,False,Matthew Genther,0,7,0,7
608,1172430,Combat Force,0,False,Matt Sowards,5,22,22,44
609,1172480,Louie,0,False,Chris Hanna,0,2,0,2
610,1172500,Hang The Kings,0,False,Minimol Games,7,18,4,22
611,1172510,Unlock The King,0,False,Minimol Games,8,112,2,114
612,1172520,Colorgrid,0,False,Minimol Games,8,58,7,65
613,1172530,Daylife in Japan - Pixel Art Jigsaw Puzzle,0,False,Minimol Games,7,34,5,39
614,1171620,"Remember, Lights Out",0,False,Mammoth Interactive INC.,0,1,0,1
615,1171640,Man Wreck,18,False,Aaron Dodo,0,2,3,5
616,1171660,The Ambassador: Fractured Timelines,0,False,tinyDino Games,7,18,0,18
617,1171770,Super Novel Collector (Speedrun Edition),0,False,Calculator Games,0,1,0,1
618,1171820,Creme de la Creme,0,False,Choice of Games,7,41,4,45
619,1171840,Ironheart,0,False,Choice of Games,7,21,2,23
620,1171870,魂之大陆 Soultia,0,False,Pisces Studio,0,1,0,1
621,1171880,ALPHA,0,False,"KANAME.co,.ltd.",0,1,0,1
622,1171950,Dragon Little Fighters 2,0,False,Blue Creazione,0,0,1,1
623,1172000,Captain Cook: Word Puzzle,0,False,Superpow,0,0,1,1
624,1172050,COCKHEAD,0,False,Yoba Games,6,272,112,384
625,1172060,Rest In Pieces,0,False,Storming Tech,6,17,7,24
626,1171240,Reiko's Fragments,0,False,Pixel Canvas Studios,6,65,24,89
627,1171260,Hollow Head: Director's Cut,0,False,Rubeki,6,12,5,17
628,1171270,TroubleDays,0,False,qureate,8,60,8,68
629,1171310,Valakas Story,0,False,Narko Games,5,51,24,75
630,1171350,Garden City,0,False,8floor,0,1,2,3
631,1171370,The Supper,0,True,Octavi Navarro,0,8,0,8
632,1171440,Hentai Halloween,0,False,IR Studio,7,21,2,23
633,1171560,Adventureland XL,0,False,Clopas LLC,0,4,0,4
634,1171570,Color Soul: Memories,0,False,Evan Streblow,0,3,0,3
635,1170830,ZLM Crafter,0,False,Zeck Wong,0,0,1,1
636,1170840,Pamp Quest,0,False,WoksOnStudios,0,1,0,1
637,1170960,The Eye of Borrack,0,False,JimJams Games,0,9,0,9
638,1170980,A Planet of Mine,0,False,Tuesday Quest,5,9,4,13
639,1171030,Bock Bock,0,False,Ben Fitzpatrick,0,1,0,1
640,1171070,Medieval - Embers of War,0,False,Evil Bunneh,0,3,1,4
641,1171080,Diesel Attack,0,False,Mates in Space,0,1,0,1
642,1171120,Nira,0,False,Baseline Games,7,17,3,20
643,1171130,Scraper: Gauntlet,0,False,"Labrodex, Inc.",7,15,0,15
644,1171160,NUVAVULT,0,False,Mim Hufford,0,6,0,6
645,1170610,Sexy Fitness Girl,0,False,Tintin Game,5,13,7,20
646,1170630,Time traveler Marie,0,False,Summoner Veil,0,0,3,3
647,1170760,XIII - Classic,0,False,Ubisoft Paris Studio,8,513,34,547
648,1170400,Labyrinth of the Witch,0,False,"ORANGE CUBE, INC.",0,0,1,1
649,1169920,SafeHome,0,False,ThirtysixLab,0,1,0,1
650,1170050,Null Drifter,0,False,Panda Indie Studio,7,9,1,10
651,1170060,Boomerang X,0,False,DANG!,8,198,9,207
652,1170110,Puzzle Game: Lee inside TV,0,False,Kyrios Game Studio,0,2,0,2
653,1170120,OUTTA GAS,0,False,Trevor Kellogg,7,33,0,33
654,1170160,Golf98,0,False,Studio Inward,0,1,0,1
655,1170170,Alfonzo's Arctic Adventure,0,False,Spoony Bard Productions,0,1,0,1
656,1170180,Beat.School: DJ Simulator,0,False,NonLinear Educating Inc.,5,13,9,22
657,1170190,Bogatyr,0,False,the Bratans,7,10,1,11
658,1170210,Is the President a Traitor?,0,False,Some Hominid Games,0,7,2,9
659,1170290,Lovely Heroines,0,False,Kavorka Play,0,3,3,6
660,1170300,Glitchangels,0,False,Pumpkin Games,0,4,0,4
661,1170320,Hentai energy: Halloween,0,False,Crew Lab,7,17,2,19
662,1170330,toz,0,False,Ismail Doner,7,10,1,11
663,1170340,Hentai Jigsaw Puzzle 2,0,False,NAISU,7,16,0,16
664,1170350,Pirate Popper VR,0,False,Jellybean Game Studios,0,1,0,1
665,1169510,Game Breaker,0,False,Game Breaker,0,1,1,2
666,1169690,Shadowplay: Metropolis Foe,0,False,Crossingstar Studio,0,6,1,7
667,1169740,Danger Scavenger,0,False,Piotr Wolk,6,32,13,45
668,1169770,Swordrite,0,False,WolflandGames,0,1,1,2
669,1169880,Hentai Quilm,0,False,Snkl Studio,0,4,1,5
670,1169020,Dark Fall: Ghost Vigil,0,False,Darkling Room,8,69,6,75
671,1169030,Monophobia,0,False,ProjectCyranis,0,1,2,3
672,1169040,Necesse,0,False,Mads Skovgaard,8,76,9,85
673,1169050,Language Worm,0,False,Christopher Pollard,0,1,0,1
674,1169060,Shield Shock,0,False,Reece Geofroy,0,1,0,1
675,1169070,RED EVIL,0,False,meokigame,0,1,3,4
676,1169100,Gazillionaire,0,False,LavaMind,8,100,9,109
677,1169160,ECHORIA: Ancient Echoes,0,False,Adam Waind,0,5,1,6
678,1169310,The Chronicles of Joseph of Egypt,0,False,e-FunSoft Games,0,2,1,3
679,1169420,Monstrüous,0,False,Arnaud Millot,0,6,1,7
680,1169430,Ransomware Dating Sim,0,True,Panlucent Games,0,1,0,1
681,1168600,Infinite Sparkles,0,False,Hardspace Creative Technology,0,1,0,1
682,1168630,Active Neurons - Puzzle game,0,False,Nikolai Usachev,7,14,0,14
683,1168650,Angry Bunny,0,False,Tero Lunkka,0,5,4,9
684,1168820,Myths of the World: The Heart of Desolation Collector's Edition,0,False,Eipix Entertainment,0,6,0,6
685,1168830,Mystery Case Files: Ravenhearst Unlocked Collector's Edition,0,False,Eipix Entertainment,5,9,5,14
686,1168850,Trix and the Horny Tower,0,False,Hentai Room,0,1,1,2
687,1168870,Mists of Noyah,0,False,Pyxeralia,5,67,37,104
688,1168880,MOLEK-SYNTEZ,0,False,Zachtronics,8,260,23,283
689,1168940,Crystal core,0,False,Z.A.Games,0,0,1,1
690,1168960,Warbrush,0,False,Clearline,0,3,0,3
691,1168970,Drunk ride,0,False,High and Wide,0,1,0,1
692,1168980,Buried Alive: The Annihilation VR,0,False,The Two Ravens,0,3,6,9
693,1168990,Planet destroyer,0,False,High and Wide,0,2,3,5
694,1168290,TD Strategy of Three kingdoms/塔防三国,0,False,Gemini Stars Games,0,0,2,2
695,1168320,Zombie valley,0,False,乌拉,0,1,1,2
696,1168360,Detective Solitaire Inspector Magic,0,False,Somer Games,0,2,0,2
697,1168420,passenger seat,0,False,Sokpop Collective,0,3,1,4
698,1168470,千面 Melancholy Love,0,False,白露社,0,5,0,5
699,1167760,4islands,0,False,RGS,0,4,1,5
700,1167770,More dark,0,False,HugePixel,0,6,1,7
701,1167800,Exphelius: Arena,0,False,Pharazen Studios,0,1,0,1
702,1167850,Penguin Park 3D,0,False,Sokpop Collective,7,9,1,10
703,1167950,Vampire's Fall: Origins,0,False,Early Morning Studio,6,168,50,218
704,1167970,Will: The Beginning,0,False,Alpakut,0,5,2,7
705,1168050,Fairytale Mosaics Beauty and Beast,0,False,Creobit,0,2,0,2
706,1168060,Knight Solitaire,0,False,Creobit,0,4,0,4
707,1168070,Mystery Solitaire The Arkham Spirits,0,False,Somer Games,0,4,0,4
708,1168170,WAIFU HORROR: The Eight Pictures,0,False,Konnichiwa Games,5,52,32,84
709,1167320,Artificial Extinction,0,False,100Hr Games,8,135,33,168
710,1167380,Neither Day nor Night,0,False,Carnotaurus Team,0,1,1,2
711,1167450,DAEMON X MACHINA,0,False,Marvelous Inc.,8,1221,164,1385
712,1167460,Hero Hours Contract,0,False,Steve O'Gorman,7,10,0,10
713,1167470,Street Jam: The Rise,0,False,Hosted Games,0,1,4,5
714,1167530,Ailment,0,False,Ivan Panasenko,0,2,0,2
715,1167540,KiKi's adventure,0,False,PhilippeStudio,0,2,1,3
716,1167550,VR MEDIA VIEWER,0,False,BoninblueDesignLaboratory,7,11,1,12
717,1167630,Teardown,0,False,Tuxedo Labs,9,14092,686,14778
718,1167640,Femida,0,False,Art Interactive,6,10,3,13
719,1167650,Context,0,False,SunshineOvercast,0,0,1,1
720,1167710,clutchball,0,False,Sokpop Collective,0,3,0,3
721,1166860,Rival Stars Horse Racing: Desktop Edition,0,False,PikPok,8,616,56,672
722,1166980,Hentai Nekogirl,0,False,GentleDriver,0,5,1,6
723,1167090,Desert coachman,0,False,迈克儿,0,0,1,1
724,1167170,Guilty Parade,0,False,Nozori Games,7,16,0,16
725,1167270,Tank Impact,0,False,MiCake,0,0,1,1
726,1166490,Live Desktop,0,False,chengcong,0,2,2,4
727,1166510,Nanoworld,0,False,Kedexa,0,0,2,2
728,1166580,Best Plumber,0,False,High and Wide,7,15,2,17
729,1166600,The Fog Knows Your Name,0,False,Choice of Games,7,35,6,41
730,1166730,nothing & nowhere,0,False,ebi-hime,0,5,0,5
731,1166740,Centralia: Homecoming,18,False,indie_games_studio,4,5,8,13
732,1166760,Jinga Online,0,False,2SD,0,1,2,3
733,1166800,Grand Academy II: Attack of the Sequel,0,False,Choice of Games,0,4,0,4
734,1166840,Breach: The Archangel Job,0,False,Hosted Games,8,47,3,50
735,1166110,Gods of Love: An Otome Visual Novel,0,False,Y Press Otomes,5,13,8,21
736,1166120,SisterFight,0,False,FoxNyan Games,0,5,0,5
737,1166130,Fighting Moore,0,False,complicatedAloofness,0,6,0,6
738,1166230,1812: Napoleon Wars,0,False,First Games Interactive,7,14,1,15
739,1166240,Asian Riddles,0,False,Creobit,0,4,3,7
740,1166250,Mahjong Gold,0,False,Creobit,0,0,2,2
741,1166290,Death and Taxes,0,False,Placeholder Gameworks,8,1298,154,1452
742,1166320,Hentai Shiri,0,False,GentleDriver,0,4,0,4
743,1166350,Alexis Almighty: Daughter of Hercules,0,False,Jetdogs Studios,0,1,2,3
744,1165740,Match Solitaire,0,False,David Taylor,0,2,0,2
745,1165750,PAGAN: Autogeny,0,False,Oleander Garden,7,19,2,21
746,1165820,Super Rebellion,0,False,Colossus Game Studio,0,4,1,5
747,1165830,Final Mission VR,0,False,OCIO Games,0,1,0,1
748,1165840,The Strange Story Of Brian Fisher: Chapter 1,0,False,Intetic,6,14,5,19
749,1165860,6.0,0,False,Tamerlan Satualdypov,6,14,4,18
750,1165870,Mahou Arms,0,False,Dischan Media,8,103,16,119
751,1165910,Humanity,0,False,Crafty Game Lab,7,8,2,10
752,1165960,Things That Bounce and Explode,0,False,LNDFRR,0,7,0,7
753,1166000,Battleships and Carriers - Pacific War,0,False,Light Strategy Series,0,5,2,7
754,1166100,Danger Course VR,0,False,Cesar G.,0,0,1,1
755,1165140,Picross Love,0,False,Inlet Pipe Productions,5,9,5,14
756,1165180,Knight Eternal,0,False,Joshua Keith,7,10,1,11
757,1165270,Synthesis Universe -Episode 00-,0,False,OlivierJT,7,23,4,27
758,1165280,Shuffle World,0,False,NanningsGames,0,1,2,3
759,1165350,Garbage Classification Simulator 垃圾分类模拟器,0,False,Barry's Lab,0,0,1,1
760,1165380,To Be Headed Or Not To Be,0,True,Fruits of Yggdrasil Studio,5,18,10,28
761,1165400,Stellar Commanders,0,False,Blindflug Studios AG,6,8,3,11
762,1165420,Detective Solitaire. Butler Story,0,False,Somer Games,0,3,1,4
763,1165460,Unlit,0,False,Clockworks,0,0,1,1
764,1165490,New Tricks for Old Gods,0,False,James K. Isaac,0,1,0,1
765,1165540,MAD Maze,0,False,MAD Dev Studio,0,1,0,1
766,1165590,It Will Find You,0,False,Mega Sloth Studios,0,2,2,4
767,1164660,SHOOTING CHICKEN BRUTAL SUCKERS,0,False,KoheiGallery,0,2,1,3
768,1164690,Wigmund. The Return of the Hidden Knights,0,False,The Scholastics,6,13,5,18
769,1164740,Salting the Earth,0,False,BitterBerries,7,43,2,45
770,1164750,Hospitality VR,0,False,David Flossdorf,6,35,13,48
771,1164910,Doll,0,False,Braisque,0,5,0,5
772,1164930,Lustful Survival,0,False,Anka,3,3,18,21
773,1164970,Dogs of Wallstreet,0,False,TeamSmoothBear,0,8,0,8
774,1164990,Skin Witch,0,False,Blackwood Specter,0,0,2,2
775,1165020,Legend of Everything,0,False,Kidalang,0,1,0,1
776,1165090,Restaurant Solitaire: Pleasant Dinner,0,False,Somer Games,0,3,0,3
777,1165100,Tasty Jigsaw: Happy Hour  (拼图),0,False,Somer Games,0,1,0,1
778,1164290,Aluna: Sentinel of the Shards,0,False,Digiart Interactive,0,7,1,8
779,1164310,Fairytale Solitaire. Witch Charms,0,False,Somer Games,0,3,0,3
780,1164330,Smile To Fly,0,False,no.rest,0,4,0,4
781,1164440,Extreme Offroad Monster Simulator,0,False,A Nostru,0,2,2,4
782,1164470,[MISC] TIMELINES,0,False,Misc.261,0,7,1,8
783,1164520,The Book Of Yorle: Save The Church,0,False,YorleTech,0,0,1,1
784,1164550,Disc Golf Adventure VR,0,False,Brian Macumber,0,6,1,7
785,1163730,Motor Assailant,0,False,DSW Games,0,3,1,4
786,1163910,Brass Brigade,0,False,Henry Kucab,8,229,27,256
787,1163950,A Dragon's Tale VR,0,False,Spillage Games,0,1,1,2
788,1163960,Paranormal Files: Hook Man's Legend Collector's Edition,0,False,Elephant Games,0,3,0,3
789,1163980,Crazy Shopping,0,False,Qmax Inc.,0,2,0,2
790,1163990,Starexcess,0,False,Super16bits,0,1,1,2
791,1164000,六阶谜题 six-step mystery,0,False,章鱼罐头制作组,0,1,0,1
792,1164010,Mouse Cursor,0,False,chengcong,6,23,6,29
793,1164050,When The Past Was Around,0,False,Mojiken,9,498,23,521
794,1164060,The Last Show of Mr. Chardish,0,False,Punk Notion,7,11,2,13
795,1163290,Vortex Attack EX,0,False,KaleidoGames,0,5,3,8
796,1163300,visser,0,False,Sokpop Collective,0,4,3,7
797,1163320,Zombie horde,0,False,金克斯,0,0,3,3
798,1163340,Carrier Battles 4 Guadalcanal - Pacific War Naval Warfare,0,False,Avalon Digital,8,74,10,84
799,1163460,Daenerys doesn’t want Hentai,0,False,SeedWall,5,15,8,23
800,1163470,Give Up The Dupe,0,False,SilbinaryWolf,0,4,0,4
801,1163490,Gangsters 1920,0,False,Sunlight Games,0,0,1,1
802,1163500,Warp Drive,0,False,Supergonk,6,12,4,16
803,1163550,Captain Tsubasa: Rise of New Champions,0,False,TAMSOFT CORPORATION,5,380,196,576
804,1163560,SuperEpic: The Entertainment War,0,False,Undercoders,5,16,11,27
805,1163570,skidlocked,0,False,Sokpop Collective,0,5,0,5
806,1163590,Bullet Girls Phantasia,18,False,SHADE Inc.,8,90,14,104
807,1163600,Omega Labyrinth Life,16,False,Matrix,6,53,14,67
808,1163620,Haunted: Poppy's Nightmare,0,False,Enigma Entertainment,0,0,1,1
809,1163660,Soul Reaper,0,False,Power Level Studios Inc.,5,8,7,15
810,1162880,Pax Ruthenia,0,False,Venezem,0,2,2,4
811,1162900,Iron Blood VR,0,False,Renderise,0,2,2,4
812,1162920,Time of the Moon,0,False,Dawnfox,0,2,0,2
813,1162950,>Connect,0,False,SheeyeDev,0,0,2,2
814,1162960,Angry Video Game Nerd I & II Deluxe,18,False,FreakZone Games,8,225,6,231
815,1163040,Billion Road,0,False,BANDAI NAMCO Entertainment Inc.,6,49,16,65
816,1163090,Boot Camp Fitness,0,False,Kevin Baker,7,17,0,17
817,1163140,Shanghai Office Simulator,0,False,机迷工作室,0,6,3,9
818,1163150,Unfamiliar,0,False,Mana Tea Games,5,11,5,16
819,1163170,Music Desktop,0,False,chengcong,0,3,0,3
820,1162520,Richman10,0,False,"Softstar Technology (Beijing) Co.,Ltd",5,108,83,191
821,1162560,"Ciconia When They Cry - Phase 1: For You, the Replaceable Ones",0,False,07th Expansion,8,172,12,184
822,1162590,Halloween with Veronica,0,False,Lesson of Passion,5,9,6,15
823,1162630,Solitaire Call of Honor,0,False,DigiMight,0,1,0,1
824,1162640,Adventure mosaics. Forest spirits,0,False,DigiMight,0,1,0,1
825,1162650,Ken ga Kimi,0,False,Rejet,0,5,0,5
826,1162670,Blocks!: Julius Caesar,0,False,Avalon Digital,5,10,13,23
827,1162680,Stigmatized Property | 事故物件,0,False,Chilla's Art,8,227,48,275
828,1162690,House Number 666,0,False,Anamik Majumdar,0,2,2,4
829,1162730,Deep Ocean Rush,0,False,TeamB,0,0,3,3
830,1162750,Songs of Syx,0,False,Gamatron AB,9,538,18,556
831,1162760,MMY: Otherworld Mystery,0,False,Dnovel,0,4,0,4
832,1162170,Below Sunshade,0,False,Arvus Games,5,21,11,32
833,1162280,Eternal Hope,0,False,Doublehit Games,7,28,2,30
834,1162290,Easy hentai puzzle 2,0,False,Laush Dmitriy Sergeevich,0,1,3,4
835,1162320,AVA: Dark History,0,False,Dnovel,0,4,0,4
836,1162350,Drill Down,0,False,Dakror Games,7,21,5,26
837,1162370,Paper - A Game of Folding,0,False,Bryce Summer,0,2,0,2
838,1162430,Salad Fields,0,False,Resni,7,13,0,13
839,1162440,Explosive Jake,0,False,PigeonDev,0,4,2,6
840,1162470,IIslands of War,0,False,jwiggs,8,51,7,58
841,1162480,DIMENSION REIGN - ROGUELIKE DECKBUILDER,0,False,ScopeNext Inc,7,15,3,18
842,1161660,Puzzlection,0,False,MiCake,0,2,0,2
843,1161670,CRASH THE GAME,0,False,Kev Jackson,0,1,0,1
844,1161680,Bomb Bowling 2,0,False,grin robot,0,1,0,1
845,1161870,Epiphyllum in Love,0,False,#workshop,0,8,1,9
846,1161880,Vaporum: Lockdown,0,False,"Fatbot Games, s. r. o.",8,71,13,84
847,1161900,Door2:Key,0,False,SVGames,4,4,8,12
848,1161910,Exile Squadron,0,False,One Bit Studio,0,3,1,4
849,1161930,東方幻夢箋 ~ Touhou Phantasm Dream,0,False,Lonhong Team,0,2,0,2
850,1162010,奇幻与砍杀2 Fantasy & Blade Ⅱ,0,False,绝汪,0,1,0,1
851,1162050,Knockout Party,0,False,Toxic studio,5,9,8,17
852,1162070,喵可莉的兔玩偶 - Nyakori's Rabbit Doll,0,False,赤瞳大白猫,8,55,3,58
853,1162130,Windbound,0,False,5 Lives Studios,5,211,133,344
854,1161270,Freud Gate,0,False,Sailors Moon Studios,5,30,13,43
855,1161300,The Legend of Crystal Valley,0,False,Cateia Games,0,1,0,1
856,1161320,东方幻昼梦~ Touhou Fantasy Day,0,False,Abudory,0,0,3,3
857,1161330,Record Life,0,False,创克游戏工作室,0,1,0,1
858,1161360,Shisensho Solitaire,0,False,Nick Ramsay,7,22,0,22
859,1161430,Noosphere,0,False,KOEX studio,7,13,3,16
860,1161490,MotoGP™20,0,False,Milestone S.r.l.,8,771,81,852
861,1161510,Lithium Inmate 39 Relapsed Edition,12,False,Stoneball L.L.C.,0,2,1,3
862,1161570,Dark Parables: Portrait of the Stained Princess Collector's Edition,0,False,Eipix Entertainment,6,11,3,14
863,1161650,Sakura Gamer 2,0,False,Winged Cloud,7,28,3,31
864,1160700,Particle Wars,0,False,HaDe Games,7,13,1,14
865,1160780,LoliTower,0,False,XCGames,0,1,1,2
866,1160790,The Legend of Dark Witch Renovation,0,False,INSIDE SYSTEM,0,6,0,6
867,1160800,Rainbow Robin,0,False,DigiPlox,0,1,1,2
868,1160820,Bewitched,0,False,Graven Visual Novels,0,8,0,8
869,1160850,Black Office - Entertainment Department,18,False,H-Keration,0,0,1,1
870,1160870,Dinosaur Hunting Patrol 3D Multiplayer Online,0,True,Vicente Rosell Roig,0,7,0,7
871,1160880,Paul's World,0,False,Cloaz Studio,0,7,2,9
872,1160900,Antarctic Girl 南極娘,0,False,Antarctic aliens,0,1,1,2
873,1160950,Yomi Alliance,0,False,Bruni Multimedia,5,19,13,32
874,1160980,Legendary Arcane 2 Universe,0,False,Maxime Côté,0,1,0,1
875,1161120,A Ghostly Tale,0,False,Renee Beaulieu,0,1,0,1
876,1161180,Funbag Fantasy: Sideboob Story 2,0,False,Waffle,7,12,0,12
877,1161190,Natsu no Iro no Nostalgia,0,False,MOONSTONE,0,3,0,3
878,1160410,Hentai Balloons,18,False,Reddiamondgames,6,8,3,11
879,1160440,PARANOIHELL,0,False,games by lum,7,10,0,10
880,1160480,Boot : Game Dev Sim,0,False,Ghost roots,0,1,6,7
881,1160500,AstronTycoon2: Ritual,0,False,ANG People s.r.o.,5,5,5,10
882,1160580,Model Melissa,0,False,Dharker Studio,5,7,5,12
883,1160610,Future Girls,0,False,Dharker Studio,0,8,0,8
884,1160620,Summer Days,0,False,Dharker Studio,7,8,2,10
885,1160670,Shrine to Anubis,0,False,Stuart Foley,0,4,0,4
886,1160100,Pixel Art Hentai Trap Hot Spring,0,False,Uzura Studio,0,2,0,2
887,1160190,Player One,0,False,Prime2Gold,0,1,0,1
888,1160330,Fight of Animals,0,False,Digital Crafter,8,162,4,166
889,1160360,Miscreation: Evolve Your Creature!,0,False,Chronicle Ltd,5,73,54,127
890,1159640,ANIME - World War II,0,False,Konnichiwa Games,8,455,78,533
891,1159680,Silent Sector,0,False,Rake in Grass,7,30,5,35
892,1159700,Knights of Light: The Prologue,0,False,Rumbling Games Studio,3,3,21,24
893,1159770,RaceXXL Space,0,False,Sars Medya,0,1,0,1
894,1159890,Supercar Drift,0,False,PLAYWHIZ GAMES Pvt Ltd,0,1,0,1
895,1159940,Astrodition,0,False,Astrodition Development,0,2,0,2
896,1160020,AshenForest,0,False,GentleRaven Games,7,23,2,25
897,1160040,Human Factory,0,False,Fire Cycle Games,0,2,0,2
898,1160050,There is a Thief in my House VR,0,False,Kucki,0,3,2,5
899,1159360,MeiQi Season1,0,False,QZQ Studio,0,1,0,1
900,1159450,Hayfever,0,False,Pixadome,7,19,1,20
901,1159480,BOW MAN,0,False,DMM VR lab,0,1,0,1
902,1159500,Ghost Files 2: Memory of a Crime,0,False,Brave Giant LTD,6,21,6,27
903,1159520,Twists of My Life,0,False,Novel,5,112,52,164
904,1159540,Fear the Dark Unknown,0,False,Dreamlight Games Studios SL,6,23,6,29
905,1159590,Lost In Dungeon,0,False,BT Studios,0,0,3,3
906,1159610,Neighbourhood Loot,0,False,Arzifact Studios,0,3,0,3
907,1158820,Mahjong Royal Towers,0,False,Creobit,0,0,1,1
908,1158830,1001 Jigsaw Castles And Palaces,0,False,Creobit,0,2,0,2
909,1158840,记忆重现/Rememory,0,False,深圳市百恩互动娱乐有限公司,0,2,0,2
910,1158850,The Great Ace Attorney Chronicles,0,False,"CAPCOM Co., Ltd.",8,480,18,498
911,1158910,Dream Detective,0,False,Century Game,0,5,1,6
912,1158970,Westmark Manor,0,False,Nodbrim Interactive,5,16,7,23
913,1159020,Your Anime Waifu,0,False,Your Waifu Factory,0,2,1,3
914,1159260,PANDARA,0,False,leimonya,0,3,0,3
915,1158310,Crusader Kings III,0,False,Paradox Development Studio,8,20411,1382,21793
916,1158320,Hentai: Memory leak,0,False,Crew Lab,7,16,4,20
917,1158390,Divan Chronicles,0,False,HJ GAMES,0,0,1,1
918,1158410,Mole Game,0,False,Joel D.,7,11,0,11
919,1158430,Jane Westlake Adventures - The Mystery Train,0,False,exosyphen studios,0,0,2,2
920,1158470,Voxelgram,0,False,Procedural Level,8,147,4,151
921,1158650,MindLess,0,False,Marco S Hampel,0,0,1,1
922,1158690,Uncharted Ocean,0,False,HiRabbit,6,62,17,79
923,1158720,Causality,0,False,WAFFLE GAMES,0,6,1,7
924,1157850,Interphase,0,False,The Assembly Line,0,1,0,1
925,1157860,Waterloo,0,False,Turcan Research Systems,0,1,0,1
926,1157890,The Binding of YOU,0,False,StarSystemStudios,0,0,1,1
927,1157910,Voxel Scavenger,0,False,ZUGALU ENTERTAINMENT,0,4,0,4
928,1157940,Gnomes & Goblins,0,False,"Wevr, Inc.",6,55,19,74
929,1157980,Ball Pit Simulator,0,False,Drew J. Stivers,0,1,0,1
930,1158010,UnHolY ToRturEr,0,False,UnholY CreatioN,6,19,7,26
931,1158150,Viking Brothers 6,0,False,Yustas Game Studio,0,2,0,2
932,1158230,Hunter's Soul,0,False,HUNTERS,0,0,1,1
933,1158260,Heroes of Hellas Origins: Part One,0,False,Jaibo Games,7,14,0,14
934,1158280,Legion 51,0,False,Nik Zayne,8,50,7,57
935,1158290,Mini Words - minimalist puzzle,0,False,Mens Sana Interactive,8,54,1,55
936,1157620,Magical MILFs,0,False,Miel,5,20,9,29
937,1157640,Sakura Fox Adventure,0,False,Winged Cloud,7,38,5,43
938,1157650,Halloween Pumpkin Smasher VR,0,False,VRX,0,3,0,3
939,1157670,Hepta Beats,0,False,Matheus Bigatão,0,5,0,5
940,1157750,CATGIRL LOVER 2,0,False,CUTE ANIME GIRLS,6,59,15,74
941,1157780,Ace of Space,0,False,StarSystemStudios,0,3,0,3
942,1157810,Dark City: Vienna Collector's Edition,0,False,Friendly Fox,0,7,0,7
943,1157820,RUNNER HEROES: The curse of night and day,0,False,IKIGAI Play,0,1,0,1
944,1156910,Galactic Management,0,False,Corkscrew Developments,0,0,2,2
945,1156980,Nijowari: Where Angels Fall,0,False,Tsukiakari Studios,0,3,1,4
946,1157010,Him and I,0,False,Xenmentia Softworks,0,4,0,4
947,1157040,Arkan: The dog adventurer,0,False,Madao Studio,0,2,1,3
948,1157080,Three Of a Fish,0,False,George,0,1,1,2
949,1157120,Zombie Season,0,True,Nic Schubert,0,0,1,1
950,1157220,Nebuchadnezzar,0,False,Nepos Games,6,244,79,323
951,1157260,GEESE vs CTHULHU,0,False,Anatoliy Loginovskikh,7,9,1,10
952,1157300,Last Shark Standing,0,False,Shark Fin Games,7,13,0,13
953,1157320,Hexagun,0,False,GraphXGames,0,3,1,4
954,1157340,Hentai Killer,0,False,PlatSTUDIO,8,398,85,483
955,1156420,Temply Girls,0,False,Red-Pixel,0,0,1,1
956,1156550,Heroes Of Avranche,0,False,Kumova Slama,0,6,1,7
957,1156590,Morels: The Hunt,0,False,Abrams Studios,8,57,11,68
958,1156630,A NIGHTMARE'S TRIP,0,False,SKY HOUR WORKS,7,19,1,20
959,1156640,Cube Attack,0,False,Pug Studio,0,1,0,1
960,1156650,Hero Of The Forest,0,False,MediocreArc,0,1,1,2
961,1156670,Balls!🤬🍆,0,False,butcha,7,15,1,16
962,1156680,Swinger-Man,0,False,Andreas Gullberg Larsen,0,3,1,4
963,1156730,Holy Knight Luviria,0,False,Daijyobi Institute,5,15,7,22
964,1156780,Teragard,0,False,Michael Squirrel,0,2,0,2
965,1156810,Channel Player,0,False,Applet LLC,0,0,1,1
966,1156900,Output Pasture,0,False,DuskDogStudio,0,1,1,2
967,1155930,Harakatsu 2,0,False,INTERHEART glossy,0,1,0,1
968,1155940,Help! I am REALLY horny!,0,False,Professional Villains,7,11,1,12
969,1155950,Treasure Tomb VR,0,False,LA12 Studios,0,1,3,4
970,1155960,HENTAI EXOTICA vol.2,0,False,Elementarium games,0,7,1,8
971,1155980,Princess Maker ~Faery Tales Come True~ (HD Remake),0,False,"CFK Co., Ltd.",0,6,1,7
972,1155990,Hentai Eroshojo,0,False,GentleDriver,0,5,2,7
973,1156000,Raindancer,0,False,Strange Creatures Studio LLC,8,63,7,70
974,1156030,Spectating Simulator The Racing,0,False,Sensei Games,0,0,2,2
975,1156050,Girl Kill Zombies,0,False,GK,5,5,5,10
976,1156120,DOOMBRINGER,0,False,Anomic Games,7,26,0,26
977,1156130,Safari Grounds - The Wilpattu Leopard,0,False,Upulanka Premasiri,0,0,1,1
978,1156200,VirtuaLiron - Immersive YOGA practice,0,False,Oshri,0,0,2,2
979,1156250,The Exorcist: Legion VR (Deluxe Edition),0,False,Wolf & Wood Interactive Ltd,8,60,14,74
980,1156360,Peaceful Days,0,False,Nhat Nguyen,8,64,4,68
981,1155460,The Academy: The First Riddle,0,False,Pine Studio,5,13,10,23
982,1155480,Doors of Silence - the prologue,0,False,Blackbite Interactive,0,2,3,5
983,1155490,Dual Blade ~ Battle of The Female Ninja ~,0,False,BEIO WOLF LTD.,0,0,2,2
984,1155500,Tower Empire Builder,0,False,Rice Rocket,0,0,2,2
985,1155560,Hooks And Shotguns,0,False,Fifth Edge Studios,0,2,0,2
986,1155620,VITAL,0,False,Icehelm,0,1,1,2
987,1155660,The Deed II,0,False,Pilgrim Adventures,7,21,2,23
988,1155670,Living with a Scarecrow,0,False,鐵日,0,2,1,3
989,1155680,Through The Dust,0,False,So Dank Studio,0,1,3,4
990,1155720,Why Is There A Girl In My House?!,0,False,Betulasoft,7,38,3,41
991,1155790,Dreamland Solitaire: Dragon's Fury,0,False,Adept Studios GD,0,6,0,6
992,1155800,Voyagers,0,False,Enki,0,2,1,3
993,1155810,Santa's Visit,0,False,Virtual Anarchy Studios,0,4,2,6
994,1155830,CHERNOBYL: The Untold Story,0,False,Mehsoft,6,24,7,31
995,1155880,The Bonfire 2: Uncharted Shores,0,False,Xigma Games,5,34,29,63
996,1155910,Dice Defenders,0,False,Full Screen Sorcery,0,1,1,2
997,1155920,Snow Clearing Driving Simulator,0,False,A Nostru,0,1,2,3
998,1154990,War Saber,0,False,Pixel Framers LLC,4,5,10,15
999,1155090,Shadows of time,0,False,GeekZebra,0,1,0,1
1000,1155130,Block Fall Simulator 2019,0,False,JumpPadGames,0,4,0,4
1001,1155230,Extend Desktop,0,False,chengcong,0,1,1,2
1002,1155290,Cartoon Kreedz: Christmas Season,0,False,Modii Games,0,1,0,1
1003,1155340,Rescue Team: Evil Genius,0,False,Platinum Games,0,3,0,3
1004,1155410,Trials of Harmony ~ A Found Phone Mystery Visual Novel,0,False,SilverTabbyCat - Visual Novel Games,7,10,1,11
1005,1155420,Dino Zoo Transport Simulator,0,False,Horse Games,0,6,2,8
1006,1154560,Counter Terrorism - Minesweeper,0,False,Black Phoenix Studio,0,0,1,1
1007,1154640,Safe Climbing,0,False,Flat Cat Games,0,2,2,4
1008,1154650,GSpot Master,0,False,Peach Beach,0,5,4,9
1009,1154680,The Guise,0,False,Rasul Mono,6,7,3,10
1010,1154700,"The diary of the cheating young married woman, Yuka.",0,False,Magical Girl Club,0,7,2,9
1011,1154730,Panic Diet!!,0,False,Panic OK!!,5,6,5,11
1012,1154790,XIII,0,False,PlayMagic,2,43,354,397
1013,1154810,Going Under,0,False,Aggro Crab,8,1036,57,1093
1014,1154840,Shadow Empire,0,False,VR Designs,8,312,64,376
1015,1154850,9th Dawn III,0,False,Valorware,8,226,25,251
1016,1154940,Football: The Hardest Job,0,False,Cleardot Games,0,6,1,7
1017,1154080,Rugby League Team Manager 3,0,False,Alternative Software Ltd,8,46,11,57
1018,1154110,Steamy Sextet,0,False,Belgerum,6,92,27,119
1019,1154160,CRYPTIC,0,False,Shoho Games,0,2,0,2
1020,1154210,Convenience Store,0,False,ChaoYe Liu,0,0,1,1
1021,1154290,Rambunny,0,False,Rambunny,0,0,1,1
1022,1154300,The Equinox Hunt,0,False,EvilStar Studios,7,14,1,15
1023,1154340,Night Road,0,False,Jared Skinner,0,4,0,4
1024,1154480,Vicious Gambling Agreement,0,False,FANG,0,2,1,3
1025,1154490,Grid Creeps,0,False,Dustin Bledsoe,0,2,0,2
1026,1153550,Dark Fairy Fantasy,0,False,JustE Fantasy,0,0,1,1
1027,1153570,Hyperventila,0,False,Tymen Muller,0,0,1,1
1028,1153670,Hentai Cosplay Elf,0,False,IR Studio,7,13,1,14
1029,1153690,Hentai Best Girls,0,False,Kotovodk Studio,0,2,3,5
1030,1153700,Eternal Magic,0,True,Duoyi,0,0,1,1
1031,1153730,SteamCity Chronicles - Rise Of The Rose,0,False,FeelThere,0,0,2,2
1032,1153840,Snow Island,0,False,MACKINN7,0,2,1,3
1033,1153850,Super Space Towers,0,False,Happy Cactus Games Limited,0,5,0,5
1034,1153860,Instacalm VR,0,False,Neurotechnology,0,1,2,3
1035,1153890,Trailing Girl,18,False,artant,0,1,6,7
1036,1153930,Easy Shooter,0,False,Funny Games,0,2,3,5
1037,1153980,Darkness Maze Cube - Hardcore Puzzle Game,0,False,YAW Studios,7,14,1,15
1038,1153990,Hacker Evolution - 2019 HD remaster,0,False,exosyphen studios,0,1,1,2
1039,1154010,Marshmallow Madness,0,False,Spaceloom Studios AB,0,0,1,1
1040,1153200,Wormskull,0,False,Wolfs Moon Studios,7,32,1,33
1041,1153220,Mahjong Dimensions 3D - Fantasy Anime,0,False,Boogygames Studios,0,1,0,1
1042,1153250,VVVVV,0,False,BekkerDev Studio,4,4,9,13
1043,1153260,Underponder,0,False,Kausemus,0,4,2,6
1044,1153330,Puzzle Patrol,0,False,Iterative Interactive,0,2,0,2
1045,1153370,Bumble Butt,0,False,Wonderthing,0,1,0,1
1046,1153430,Love wish,0,False,Double W,8,112,21,133
1047,1153460,Axegend VR,0,False,Subversion Squad Studio,7,15,1,16
1048,1153470,Empire Live,0,False,Osmose Studio,0,3,1,4
1049,1152670,Operation: Cheek Clapper,0,False,Satrio Dewantono,0,6,0,6
1050,1152800,Buggy Bump,0,False,MoonShine Games,0,0,1,1
1051,1152810,Love with Kadyrov,0,False,Taxincrease,0,3,2,5
1052,1152820,Everslash,0,False,Jaemin Park,0,3,0,3
1053,1152830,BounceBall3D,0,False,Elphie,0,2,0,2
1054,1152840,Gator Parade,0,True,Oddfellows Software,0,5,0,5
1055,1152900,KMP,0,False,chengcong,0,4,0,4
1056,1152920,N.a.N Industry VR,0,True,Armin Rigo,0,1,0,1
1057,1152950,Blackberry,0,False,Andeo TEAM,5,7,7,14
1058,1153040,Primate Signal,0,False,bankbank,0,2,2,4
1059,1153070,Hentai Zodiac Puzzle 2,0,False,Zodiacus Games,7,17,2,19
1060,1153100,Pixels can fight,0,False,DrommerKode,0,1,0,1
1061,1153110,Rally Drift Cars,0,False,Polantronic,0,0,2,2
1062,1152160,Might is Right,0,False,Lazy Kitty,6,37,10,47
1063,1152300,Atelier Ayesha: The Alchemist of Dusk DX,0,False,"KOEI TECMO GAMES CO., LTD.",8,57,1,58
1064,1152310,Atelier Escha & Logy: Alchemists of the Dusk Sky DX,0,False,"KOEI TECMO GAMES CO., LTD.",7,28,2,30
1065,1152320,Atelier Shallie: Alchemists of the Dusk Sea DX,0,False,"KOEI TECMO GAMES CO., LTD.",7,20,3,23
1066,1152360,CLIMB OUT!,0,False,Dreamverse Entertainment,0,3,1,4
1067,1152420,Heraldry Studio,0,False,Maris Ozols,7,25,2,27
1068,1152440,Party Pumper,0,False,Fibrum Limited,5,7,7,14
1069,1152450,Creeps Creeps? Creeps!,0,False,Take Toad,7,13,0,13
1070,1152480,Death To The Dragon Lord,0,False,Left Flank Games,0,1,0,1
1071,1152540,Shark Castle,0,False,Sublunary Studio,0,0,1,1
1072,1152580,Ann Achronist: Many Happy Returns,0,False,Maybe Later Games,7,12,0,12
1073,1152640,Snake: The Elder Forest,0,False,Fractal Dimension Games,0,1,0,1
1074,1151770,Dragon Slayer,0,False,Silver Cloud,0,1,2,3
1075,1151840,Sir'HaXXX,0,False,GreatherGames,0,3,1,4
1076,1151930,Buissons,0,False,Tambouille,7,15,0,15
1077,1151940,Super Minesweeper attACK,0,False,Triadne,0,2,0,2
1078,1152020,Return Of The Zombie King,0,False,"Return To Adventure Mountain, LLC",6,31,8,39
1079,1152040,Dark Romance: The Ethereal Gardens Collector's Edition,0,False,Domini Games,0,4,1,5
1080,1152050,Sword of the Slayer,0,False,Choice of Games,0,4,3,7
1081,1152090,Elmarion: Dragon time,0,False,Fleon Games,6,139,48,187
1082,1152120,Bowsette,0,False,Synovia Game,5,10,6,16
1083,1151310,Blackbeard the Cursed Jungle,0,False,Boogygames Studios,0,0,1,1
1084,1151400,Furious Goal,0,False,czgame,0,1,2,3
1085,1151430,Magnia,0,False,NoDeadLineGames,0,4,0,4
1086,1151440,Utawarerumono: Mask of Truth,0,False,AQUAPLUS,8,134,2,136
1087,1151450,Utawarerumono: Prelude to the Fallen,0,False,AQUAPLUS,8,76,3,79
1088,1151500,fight wisdom,0,False,pengjianNiu,0,2,0,2
1089,1151580,1984 Rewired,0,False,Otherside Interactive,0,1,0,1
1090,1151600,Chernobyl: Road of Death,0,False,diedemor studio,0,5,0,5
1091,1151620,磨难之间 SUFFERING: Reincarnation of Sins,0,False,噬零工作室,0,1,1,2
1092,1151630,House of 1000 Doors: Family Secrets,0,False,Five BN,7,20,2,22
1093,1151650,Shard,0,False,Riyko Games,0,3,0,3
1094,1151670,EEP  16 Expert Eisenbahn Aufbau- und Steuerungssimulation,0,False,Trend Redaktions- und Verlagsgesellschaft mbH,0,2,2,4
1095,1151680,Galactic Rangers VR,0,False,DGMA,7,12,0,12
1096,1151740,Prison Princess,0,False,qureate,7,31,1,32
1097,1151750,mmmmm donuts arhhh......,0,False,Easy game,5,6,4,10
1098,1150790,GraFi 4,0,False,Blender Games,0,5,1,6
1099,1150800,Breeza Budgie Bill,0,False,Wampee,0,1,0,1
1100,1150810,Slime Slam,0,False,Tyler M Richardson,0,2,0,2
1101,1150890,The Bunker 69,0,False,xxxmenshxxx,6,55,17,72
1102,1150950,Timelie,0,False,Urnique Studio,8,417,24,441
1103,1151080,Legend of Keepers: Prologue,0,True,Goblinz Studio,0,1,0,1
1104,1151120,Arrest of a stone Buddha,0,False,yeo,8,49,12,61
1105,1151160,Chaos Theory Pirates,0,False,Chaos Theory Studios Ltd.,0,2,1,3
1106,1151180,Super Cucho,0,False,Take Toad,0,3,1,4
1107,1151200,Just Drift It !,0,False,Vencious Games,7,11,2,13
1108,1151250,Horror Story: Hallowseed,0,False,Jeff Winner,7,42,5,47
1109,1150270,NEON SPACE WAR,0,False,OOpopgames,0,0,1,1
1110,1150310,Let's Go! Skiing VR,0,False,DGMA,0,0,1,1
1111,1150400,The Ancient Labyrinth,0,False,Nicola Gaeta,0,5,0,5
1112,1150460,Summer Paws,0,False,Manic Hyena,8,94,3,97
1113,1150500,Voidspace,0,False,Universe Projects Inc.,5,8,10,18
1114,1150540,Offcoast,0,False,Ice-Cold Shivering Studios,0,1,0,1
1115,1150550,Winter Polaris,0,False,stage-nana,7,13,0,13
1116,1150580,History Warriors,0,False,"Clipstories, Inc.",0,0,2,2
1117,1150590,Samurai Jack: Battle Through Time,0,False,Soleil Ltd.,8,407,74,481
1118,1150610,City Gangs San Andreas,0,False,Polantronic,0,2,0,2
1119,1150620,Bed Lying Simulator 2020,18,False,Oblomov Industries,7,29,7,36
1120,1150720,Monster Girl Club Bifrost,0,False,Midnight Pleasure,8,166,7,173
1121,1150730,Island SAGA,0,False,Kamichichi,8,47,6,53
1122,1149930,Tale's Casino Escape,0,True,Thales Caus,0,2,0,2
1123,1150070,Mizari Loves Company,0,False,Reine Works,0,6,1,7
1124,1150090,Learning Factory,0,False,Luden.io,7,34,6,40
1125,1150130,吾光笔记Holimas Z Notebook,0,False,Static spring,0,1,0,1
1126,1150160,KobberParty - Castle Explorer,0,False,MightyCodeDragon,0,1,1,2
1127,1149440,Dragon Marked For Death,0,False,"INTI CREATES CO., LTD.",8,188,36,224
1128,1149510,The Leopard Catgirl in Miaoli,0,False,Erotes Studio,7,9,2,11
1129,1149550,Utawarerumono: Mask of Deception,0,False,AQUAPLUS,8,140,9,149
1130,1149580,Super Korotama,0,False,Catness Game Studios,0,2,0,2
1131,1149590,Dreamland Solitaire,0,False,Adept Studios GD,7,11,0,11
1132,1149660,Seek Girl Ⅱ,0,False,DSGame,6,157,41,198
1133,1149690,Hexogin,0,False,Infinite Loop Games,7,10,1,11
1134,1149700,Dark Veer,0,False,HANNMADE Studios,0,2,0,2
1135,1149710,Tesla Force,0,False,10tons Ltd,6,45,15,60
1136,1149860,Arsenal Demon,0,False,Blast Programming,7,12,0,12
1137,1149080,Swords and Sandals Spartacus,0,False,Whiskeybarrel Studios,0,6,3,9
1138,1149090,Hospital 9,0,False,Sonic-Alpha,0,2,1,3
1139,1149120,Drift 1969,0,False,Polantronic,0,0,1,1
1140,1149190,Errant Heart,0,False,Pseudome Studios LLC,0,0,1,1
1141,1149200,Spirit Fighters,0,False,ZarioSide,0,0,1,1
1142,1149210,Turtle Rush,0,False,AmkZul Media,0,1,0,1
1143,1149220,P.3,0,False,DevJgame,0,2,0,2
1144,1149370,Broken Spell,18,False,Jaming Game Studio,0,2,1,3
1145,1148550,TERROR SQUID,0,False,Apt Games,0,6,2,8
1146,1148590,DOOM 64,16,False,id Software,8,2429,147,2576
1147,1148620,Plunder,0,False,IB Games,0,5,0,5
1148,1148650,The Legend of Bum-Bo,0,False,Edmund McMillen,6,2461,661,3122
1149,1148670,Annals of Rome,0,False,Level 9 Computing,0,3,0,3
1150,1148680,Austerlitz,0,False,Turcan Research Systems,0,1,0,1
1151,1148710,Miriel Saga,0,False,NG+ Studios,0,1,0,1
1152,1148730,Errant Kingdom (Chapters 0-5),0,False,Lunaris Games,7,26,4,30
1153,1148740,Far From Orbit,0,False,Alexander Conway,0,1,0,1
1154,1148750,Advisors at the End of the Universe,0,False,Adam Wilkes,0,1,0,1
1155,1148770,Not An Angels: Erotic Puzzle,0,False,13 Faces Games,0,2,0,2
1156,1148890,Protect the campus,0,False,CC,0,0,1,1
1157,1148910,ShapeWorks,0,False,GameDev_ToolMaker,5,10,5,15
1158,1148920,Hentai Pix,0,False,Hnew,0,3,2,5
1159,1148930,Chuusotsu! 1.5th Graduation: The Moving Castle,0,False,Studio Beast,0,7,0,7
1160,1148940,Hentai Mizugi,0,False,GentleDriver,0,2,1,3
1161,1148960,Kids Cartoon Maker,0,False,Russpuppy LLC,0,5,2,7
1162,1148980,Occupational Hazards: Episode 1,0,False,Samantha Snow,6,10,3,13
1163,1148080,Rainbow Pixel - Color by Number,0,False,Somer Games,0,1,0,1
1164,1148090,Solitaire Game Halloween,0,False,Creobit,0,6,0,6
1165,1148150,Man of the House,18,False,Faerin Games,8,480,63,543
1166,1148260,King of Halloween,0,False,King Key Games,0,3,0,3
1167,1148270,The Final Battle,0,False,PSS,0,1,0,1
1168,1148290,Thy Kingdom Crumble,0,False,Julian Edison,0,2,0,2
1169,1148320,Masteroid,0,False,Narfox LLC,7,17,3,20
1170,1148360,Alisa Quest,0,False,ShiroKuroSoft,0,5,1,6
1171,1148430,Rescue Team 8,0,False,GameOn Production,0,3,1,4
1172,1148450,Detective Jackie - Mystic Case,0,False,Old Skull Games,7,26,2,28
1173,1148460,Inside The Cubes,0,False,ViRmode,0,0,1,1
1174,1148470,Killjoy Hunter Yuuko,0,False,minori,0,6,1,7
1175,1148480,SPACERIFT: Arcanum System,0,False,Arcanum Team,5,6,5,11
1176,1148500,PuPaiPo Space Deluxe,0,False,BolHut,0,3,0,3
1177,1148510,Pretty Angel,0,False,GirlGame,8,408,25,433
1178,1148530,Griddlers Legend Of The Pirates,0,False,Somer Games,0,2,4,6
1179,1148540,Griddlers Victorian Picnic,0,False,Big Up Studio,0,1,0,1
1180,1147710,Cute Blocks,0,False,cBlck,0,1,0,1
1181,1147760,The End of an Actress,0,False,ebi-hime,0,6,1,7
1182,1147840,Hyper Storm,0,False,MotionHouse,0,2,0,2
1183,1147850,Brother Brother,0,False,Patrick VanMackelberg,0,7,0,7
1184,1147940,3dSen PC,0,False,Geod Studio,8,204,10,214
1185,1147960,Okaeri,0,False,Chilla's Art,6,94,33,127
1186,1147970,Abode 2,0,False,Overflow,8,68,16,84
1187,1147980,Gene Rain:Wind Tower,0,False,Deeli Network,0,1,3,4
1188,1148000,Squirrel Jump,0,False,Boogygames Studios,0,0,1,1
1189,1148010,Love Chan,0,False,Hnew,0,4,3,7
1190,1147370,The Empire's Crisis,0,False,Clayton Rowe,0,1,1,2
1191,706200,Celtabula,0,False,Skip32,0,1,1,2
1192,706240,Gravity Light,0,False,Ruskija game experience,0,3,1,4
1193,706280,Devil in the Pines,0,False,Rebelware Games,7,15,2,17
1194,706320,Trivia Vault: Mini Mixed Trivia,0,False,Ripknot Systems,5,7,9,16
1195,706330,Trivia Vault: Mini Mixed Trivia 2,0,False,Ripknot Systems,5,5,6,11
1196,706350,Mari and the Black Tower,0,False,Joshua Keith,0,3,1,4
1197,706370,LOGistICAL: USA - Oregon,0,False,Sacada,0,5,1,6
1198,706380,LOGistICAL: Norway,0,False,Sacada,0,1,0,1
1199,706390,LOGistICAL: Chile,0,False,Sacada,0,7,1,8
1200,706440,Cyborg Arena,0,False,Devdan Games,5,9,6,15
1201,706490,Little hidden city,0,False,3dinvis games,5,45,30,75
1202,706520,BlackShield: Upora Story,0,False,"Shanghai Vsensory Network Technology Co.,LTD",5,15,8,23
1203,706560,Jimmy and the Pulsating Mass,0,False,Kasey Ozymy,8,255,17,272
1204,706570,The Seven Stages,0,False,Weston Bell-Geddes,0,3,2,5
1205,705700,Stripper Anya™ 2 X-MiGuFighters,0,False,"X-MiGuPLAY, LLC",0,4,5,9
1206,705710,Sense of The Devil,0,False,Racing Bros,4,13,38,51
1207,705750,American Patriots: Boston Tea Party,0,False,Cult Software,7,41,5,46
1208,705770,The Donnerwald Experiment,0,False,Wegenbartho Games,0,5,0,5
1209,705780,Ancient Future,0,False,Binary Fusion,0,4,1,5
1210,705800,Astroe,0,True,Superstruct,0,2,1,3
1211,705870,Echo Grotto,0,False,Gaugepunk Games,7,43,5,48
1212,705920,Empress of Gold,0,False,Tobop Productions,0,1,0,1
1213,705930,The Trace,0,False,shenzhen YuHui Technologyco.LTD,0,0,1,1
1214,706010,The Unseen,0,False,Dynasty Interactive Ltd,0,0,2,2
1215,706020,Fade to Silence,0,False,Black Forest Games,5,287,153,440
1216,706030,Parking Cop Simulator,0,False,Shoho Games,0,6,2,8
1217,706130,Far from Noise,0,False,George Batchelor,8,45,5,50
1218,705210,Cube Racer,0,True,Simon Blasen,0,1,0,1
1219,705230,InGame.exe,0,False,Blind Recluse,0,1,2,3
1220,705240,Boom Box Blue!,0,False,VaragtP,0,1,1,2
1221,705250,Cross Set Infinity,0,False,Cuveet Story,6,10,4,14
1222,705260,Waste Cleaner,0,False,Logic Droid,0,1,0,1
1223,705280,Hakoniwa Explorer Plus,0,False,suxamethonium,8,154,27,181
1224,705290,Strange Telephone,0,False,HZ3 Software,8,99,22,121
1225,705300,Suicide Adventures,0,False,Idea Cabin,5,11,15,26
1226,705340,Kofi Quest: Alpha MOD,0,False,Loftur Studio,7,13,2,15
1227,705380,Galactic Shipwright,0,False,NanoidGames,6,10,3,13
1228,705390,Aya's Journey,0,False,Boogygames Studios,5,6,7,13
1229,705440,Onager!,0,False,rusty games,0,2,1,3
1230,705450,Wunderdoktor,0,False,Ghostbutter,7,29,5,34
1231,705500,Tiny Bubbles,0,False,Pine Street Codeworks LLC,7,20,2,22
1232,706510,SOMOS,0,False,Sideline,0,8,0,8
1233,1197280,Cyber Pussy 2020,0,False,Cyber Keks,6,13,5,18
1234,1196320,Blood Scrolls,0,False,Adrien E. Brown,0,1,0,1
1235,1190840,Boomer Remover,0,False,RIVERSIDE SPORTS,0,9,0,9
1236,1188100,Dragon Stone - Legendary Archer,0,False,MoonlightGames,0,1,0,1
1237,1184480,Inertial Drift,0,False,Level 91 Entertainment,8,256,19,275
1238,1179220,Gaijin Troubles,0,False,Grim's Studio,6,10,3,13
1239,1176560,The Orphan A Tale of An Errant Ghost - Hidden Object Game,0,False,Deertwig Studio,3,2,9,11
1240,1174900,MiMiMiShKa,0,False,Zloy Krot Studio,0,1,2,3
1241,1170750,MOR...E TRAINER (Learning Morse Code),0,False,brusnik.com,0,3,0,3
1242,1166780,Interactivity: The Interactive Experience,0,False,Aetheric Games,6,10,4,14
1243,1165610,Titeuf: Mega Party,0,False,Balio Studio,0,0,1,1
1244,1165920,Lives so Sweet,0,False,Reine Works,0,6,3,9
1245,1164410,Restless Hero,0,False,Restless Corp.,0,4,0,4
1246,1161440,World War 2 Winter Gun Range VR Simulator,0,False,Monkey Reality,0,1,2,3
1247,1160490,Master Of Pottery,0,False,AZGames,8,286,4,290
1248,1154720,Re:Gals Panic,0,False,Peach Beach,5,9,7,16
1249,1153540,Concept Destruction,0,False,Thinice Games,7,27,3,30
1250,1152890,The Delirium Vacation,0,False,Ex Conspectu,0,1,0,1
1251,506030,MAGIX PC Check & Tuning 2017 Steam Edition,0,False,simplitec GmbH,0,2,4,6
1252,506090,Switch - Or Die Trying,0,False,Threye Interactive,0,2,2,4
1253,506140,Shop Heroes,0,True,"Cloudcade, Inc.",6,23,7,30
1254,506150,Dragon Bros,0,False,Space Lizard Studio LTD,7,10,1,11
1255,506160,VR Fractals,0,False,Phylliida,0,3,3,6
1256,506260,Cladun Returns: This Is Sengoku!,0,False,"Nippon Ichi Software, Inc.",5,13,7,20
1257,506470,Quip Anomaly,0,False,mentics,0,3,1,4
1258,506500,Party Panic,0,False,Everglow Interactive Inc.,6,289,107,396
1259,506510,Shadows of Adam,0,False,Something Classic Games LLC,8,124,9,133
1260,505550,Stream Buddy,0,False,Stardale Studio,5,6,5,11
1261,505630,Let Them Come,0,False,Tuatara Games,8,312,44,356
1262,505640,Antihero,0,False,Tim Conkling,8,283,59,342
1263,505660,The Crystal Nebula,0,False,Tristan Hodges,7,14,0,14
1264,505680,Glaive,0,False,"Nest Egg Games, LLC",6,10,3,13
1265,505700,Anyland,0,True,Anyland + Manyland,8,138,5,143
1266,505730,Holy Potatoes! We’re in Space?!,0,False,Daylight Studios,6,145,55,200
1267,505750,Trimmer Tycoon,0,True,Improx Games,7,20,3,23
1268,505070,Secrets of Me,17,False,Dogenzaka Lab,6,21,6,27
1269,505080,Gakuen Club,13,False,OperaHouse Corporation,5,24,14,38
1270,505090,The Charming Empire,0,False,OperaHouse Corporation,5,22,22,44
1271,505110,Ghost Pursuit VR,0,False,Raf1Dev,0,4,0,4
1272,505120,Valentino Rossi The Game Compact,0,False,Milestone S.r.l.,0,5,3,8
1273,505140,Tribe Of Pok,0,False,Poking Water Games,0,3,3,6
1274,505170,Carmageddon: Max Damage,18,False,Stainless Games Ltd,6,716,212,928
1275,505210,Neon Space 2,0,False,EGAMER,5,54,25,79
1276,505220,King of Spin VR,0,False,Wicked Witch,0,4,3,7
1277,505270,The Food Run,0,False,Battenberg Software,0,3,1,4
1278,505290,Super Rock Blasters!,0,False,QuadraTron Games,0,2,0,2
1279,505330,Apocalipsis,0,False,Punch Punk Games,5,55,28,83
1280,505400,Diamond Joyce and the Secret of Crystal Cave,0,False,Rake in Grass,0,9,0,9
1281,504620,"Grid Legion, Storm",0,True,Wind Jester Games,0,3,0,3
1282,504630,Broomball VR,0,True,Rushil Reddy,0,1,1,2
1283,504660,Tears Revolude,0,False,WorldWideSoftware,0,2,1,3
1284,504670,FARIA: Ghosts of the Stream,0,False,Faria,0,4,2,6
1285,504690,Woven,0,False,Alterego Games,6,30,8,38
1286,504700,Blockships,0,False,Dr Davient,7,18,1,19
1287,504710,Music Maker 2017 Steam Edition,0,False,MAGIX Software GmbH,5,27,32,59
1288,504750,Lew Pulsipher's Doomstar,0,False,Large Visible Machine,0,5,2,7
1289,504770,Slavistan,0,False,Free Candy Games,8,429,37,466
1290,504790,Fables from the Den,0,False,Might and Delight,7,25,2,27
1291,504800,Sorcery! Part 4,0,False,inkle Ltd,8,43,10,53
1292,504810,MXGP2 - The Official Motocross Videogame Compact,0,False,Milestone S.r.l.,5,11,5,16
1293,504840,Brick Stack VR,0,False,Andrew French,7,10,0,10
1294,504850,Castle Invasion: Throne Out,0,False,Cat Trap Studios,0,5,2,7
1295,504880,Pixel Puzzles 2: RADical ROACH,0,False,The Digital Puzzle Company,6,15,5,20
1296,504920,39 Days to Mars,0,False,It's Anecdotal,6,46,12,58
1297,504980,Elves Adventure,0,False,Patryk Taranek,5,7,5,12
1298,505020,Neon Exile,0,False,Mythical City Games,0,4,2,6
1299,505060,Warcube,0,False,craigz,8,199,20,219
1300,504100,Russian VR Coasters,0,False,Funny Twins,5,9,8,17
1301,504110,The Longest Five Minutes,0,False,"Nippon Ichi Software, Inc.",5,8,6,14
1302,504130,Manual Samuel - Anniversary Edition,0,False,Perfectly Paranormal,6,273,80,353
1303,504210,SHENZHEN I/O,0,False,Zachtronics,9,1457,69,1526
1304,504230,Celeste,0,False,"Extremely OK Games, Ltd.",9,17323,422,17745
1305,504240,Graveyard Smash,0,False,Four Mans Games L.L.C.,0,0,1,1
1306,504260,Happy Pong,0,False,Poppgames,0,3,2,5
1307,504280,The Cold War Era,0,False,Alina Digital,5,7,6,13
1308,504310,The Cooking Game,0,True,Play Spirit Limited,5,21,17,38
1309,504370,Battlerite,0,True,Stunlock Studios,8,8548,1203,9751
1310,504380,Detective Hayseed - Hollywood,0,False,Zima Software,0,7,1,8
1311,504390,Along the Edge,0,False,Nova-box,8,103,16,119
1312,504400,Optika,0,False,PlayZilla.tk,6,42,13,55
1313,504410,Escape from Pleasure Planet,0,False,Up Multimedia,5,17,13,30
1314,504420,Malazard: Magic Defense,0,False,Invictus Games Ltd.,6,13,4,17
1315,504450,StarSmashers,0,False,Wayne Jackson,0,3,5,8
1316,504460,Team Racing League,0,False,Gamious,0,8,1,9
1317,504470,Salvaged,0,False,Opposable Games,4,4,7,11
1318,504490,The God's Chain,0,False,CRASS Studios,0,3,4,7
1319,504500,Hover Havoc,0,False,Canalside Studios,0,3,1,4
1320,504560,The Unwelcomed,0,False,The Unwelcomed Studios,5,15,9,24
1321,503620,Fictorum,0,False,Scraping Bottom Games,6,513,148,661
1322,503630,INVASION!,0,True,Baobab Studios Inc.,0,5,0,5
1323,503650,Fenimore Fillmore: The Westerner,0,False,Casual Brothers,7,10,2,12
1324,503680,The Seeker,0,False,VisualTech48,0,4,0,4
1325,503690,Starship Disco,0,False,"Solus Games, Inc.",0,3,1,4
1326,503700,Fall of Freya (Alpha 1),0,False,GOTY LLC,0,0,2,2
1327,503710,Void,0,False,Pathless Games,0,5,4,9
1328,503730,Saving Harmony,0,False,Daniel Mercier,0,1,2,3
1329,503750,SPLASH BLAST PANIC,0,False,Team KwaKwa,0,1,0,1
1330,503770,Elven Assassin,0,False,Wenkly Studio Sp. z o.o.,8,306,51,357
1331,503780,Ice Caves of Europa,0,False,Io Normal,0,2,3,5
1332,503820,A Detective's Novel,0,False,Amaterasu Software,5,11,8,19
1333,503830,The Life Of Greather,0,False,GreatherGames,5,21,17,38
1334,503860,Patterna,0,False,Sebastian Schöner,7,23,1,24
1335,503900,Candy Smash VR,0,False,Wadup Games,0,1,3,4
1336,503940,Railway Empire,0,False,Gaming Minds Studios,8,2223,553,2776
1337,503950,Star Tactics Redux,0,False,Devil's Dozen Games,6,13,4,17
1338,503960,Will of the Gods,0,False,Comrades Inc.,6,14,5,19
1339,503980,Detective Hank and the Golden Sneeze,0,False,Obsessive Science Games,0,6,1,7
1340,504000,Endless Fables: The Minotaur's Curse,0,False,Sunward Games,8,48,6,54
1341,504010,Chernobyl VR Project,0,False,The Farm 51 Group SA,5,11,5,16
1342,504050,Planet Nomads,0,False,Craneballs,5,555,259,814
1343,504090,3..2..1..Grenades!,0,False,Banyango,7,14,0,14
1344,503090,Fairy Maids,0,False,Spark Plug Games,0,1,3,4
1345,503100,Black Hat Cooperative,0,False,Team Future LLC,6,39,16,55
1346,503130,Red is Dead - The Complex Fun Random Level Fast Strategy Game,0,False,Theodore Palser,0,6,1,7
1347,503140,Dungeon Punks,0,False,Hyper Awesome Entertainment,0,6,0,6
1348,503150,Frantic Freighter,0,False,Phr00t's Software,7,12,1,13
1349,503180,miniLAW: Ministry of Law,0,False,"Lasso Games, LLC",8,93,21,114
1350,503210,Sentry Knight Tactics,0,False,Tyler Myers,6,45,16,61
1351,503280,Marble Land,0,False,Devious Technologies,7,29,5,34
1352,503290,Maraiyum: Rise of the Setting Sun,0,False,Humdrum Software LLC,0,3,2,5
1353,503300,Super Star,0,False,Dream Works,6,571,154,725
1354,503340,Dig 4 Destruction,0,False,"COLOPL, Inc.",7,31,6,37
1355,503350,White Noise 2,0,False,Milkstone Studios,6,613,170,783
1356,503370,Hospitalize,0,False,Illeris,5,47,66,113
1357,503390,Roomscale Tower,0,False,DuplicatorStudio,5,7,7,14
1358,503400,Four Last Things,0,False,Joe Richardson,8,371,21,392
1359,503410,Zombie Camp,0,False,Void Dimensions,5,8,4,12
1360,503450,Space Rangers: Quest,0,False,SNK Games,0,2,3,5
1361,503460,Security Hole,0,False,AnRaEl,5,12,8,20
1362,503480,Mahluk:Dark Demon,0,False,Serkan Bakar,5,15,12,27
1363,503550,DYE,0,False,"Bat Country Games, LLC",6,36,11,47
1364,503560,911 Operator,0,False,Jutsu Games,8,3567,508,4075
1365,503580,Duck Season,0,False,Stress Level Zero,8,715,134,849
1366,502600,The Multidimensional Underwear Drawer,0,False,KamiyaSoft,0,5,3,8
1367,502650,Autumn Park Mini Golf,0,False,Serious Tangents,5,15,8,23
1368,502700,Laser Lasso BALL,0,False,RagTagRadical,0,8,1,9
1369,502740,50 years,0,False,Aleksandr Golovkin,8,156,19,175
1370,502750,Quest for Glory 1-5,0,False,Sierra,8,177,11,188
1371,502770,Voodoo Garden,0,False,M. Hanka,6,236,67,303
1372,502780,Avalon: The Journey Begins,0,False,NewHopeGames,0,6,2,8
1373,502800,SENRAN KAGURA ESTIVAL VERSUS,0,False,Tamsoft,8,1042,56,1098
1374,502810,Tank Hero VR,0,False,Edougame,0,0,4,4
1375,502820,Batman™: Arkham VR,0,False,Rocksteady Studios,5,495,223,718
1376,502880,The Janitor,0,False,VOS Gaming,4,4,16,20
1377,502910,The Return Home Remastered,0,False,AL-GAME,0,1,6,7
1378,502920,Gunnihilation,0,False,Robo Pixel Games,0,6,0,6
1379,502940,"Calm Down, Stalin",0,False,Cartboard Games,8,309,37,346
1380,502990,Kisaragi no Hougyoku,0,False,Waiting for you guys,0,0,1,1
1381,503010,Azulgar: Star Commanders,0,False,SZEINER,5,7,9,16
1382,503050,Heroes from the Past: Joan of Arc,0,False,Green Sauce Games,0,1,0,1
1383,503060,The Agency of Anomalies: Mystic Hospital Collector's Edition,0,False,Orneon,0,7,0,7
1384,503070,Off the Record: The Italian Affair Collector's Edition,0,False,Eipix Entertainment,0,8,1,9
1385,503080,Echoes of the Past: Kingdom of Despair Collector's Edition,0,False,Orneon,0,3,1,4
1386,502090,Invisible Mind,0,False,VGstudio,4,4,11,15
1387,502100,Death's Life,0,False,Umbu Games,5,10,6,16
1388,502140,Drayt Empire,0,False,RPG Video,5,21,26,47
1389,502150,Interstellar Logistics Inc,0,False,Exalted Guy Interactive,7,9,1,10
1390,502200,Orczz,0,False,Camel 101,0,3,2,5
1391,502210,Super Markup Man,0,False,Roppy Chop Studios,7,35,5,40
1392,502230,Monsters' Den: Book of Dread,0,False,Monstrum,8,88,7,95
1393,502240,You Deserve,0,False,TGA Company LLC,5,19,24,43
1394,502280,BERSERK and the Band of the Hawk,18,False,"KOEI TECMO GAMES CO., LTD.",6,783,202,985
1395,502300,Heartomics: Lost Count,0,False,Heartomics,5,9,7,16
1396,502320,Boulder Dash - 30th Anniversary,0,False,BBG Entertainment GmbH,5,26,12,38
1397,502340,Unbound,0,False,"Unbound Technologies, Inc.",5,9,4,13
1398,502370,"Warhammer 40,000: Sanctus Reach",0,False,Straylight Entertainment,8,572,93,665
1399,502400,Redactem,0,False,Elliott,5,10,6,16
1400,502410,Airport Fire Department - The Simulation,0,False,VIS-Games,5,7,6,13
1401,502420,Firefighters - The Simulation,0,False,VIS-Games,5,17,17,34
1402,502430,Roadworks - The Simulation,0,False,VIS-Games,0,5,4,9
1403,502440,Plant Fire Department - The Simulation,0,False,VIS-Games,0,2,4,6
1404,502450,Professional Construction - The Simulation,0,False,VIS-Games,0,0,4,4
1405,502460,Hotel Giant,0,False,QLOC,0,5,0,5
1406,502470,Airport Simulator 3: Day & Night,0,False,United Independent Entertainment GmbH,4,3,9,12
1407,502480,VoxVR,0,True,Broken Vector,0,3,2,5
1408,502520,Ultimate General: Civil War,0,False,Game-Labs,8,3344,431,3775
1409,502530,THE GREY MAN,0,False,ATTACK MOUNTAIN,0,7,2,9
1410,502540,Cold Vengeance,0,False,Renegade Sector Games,7,14,2,16
1411,502550,Strike.is: The Game,0,True,Freakinware Limited,5,7,4,11
1412,501740,Dropship Down,0,False,Fast Forward Games,4,2,8,10
1413,501760,Francisca,0,False,Kiddy,5,32,37,69
1414,501840,Don't Disturb,0,False,Midnight Party,6,45,16,61
1415,501850,DCR: Drive.Crash.Repeat,0,False,Tarboosh Games,0,1,0,1
1416,501860,Slayer Shock,0,False,Minor Key Games,5,38,28,66
1417,501930,Sig.NULL,0,False,SaintHeiser,6,16,6,22
1418,501940,Hikikomori No Chuunibyou,0,False,Blaze Epic,5,12,9,21
1419,501950,Rogue Islands,0,False,Big Fat Alien,5,18,9,27
1420,501970,Phantasmagoria 2: A Puzzle of Flesh,0,False,Sierra,7,41,7,48
1421,501990,Phantasmagoria,0,False,Sierra,8,83,13,96
1422,501180,Acan's Call: Act 1,0,True,Cyberith GmbH,5,8,4,12
1423,501190,Axis Football 2016,0,False,Axis Games,5,48,25,73
1424,501220,Space Ribbon - Slipstream to the Extreme,0,False,Onteca Ltd,5,19,14,33
1425,501270,Robots In The Wild,0,False,Heatbox Games,0,2,1,3
1426,501300,What Remains of Edith Finch,0,False,Giant Sparrow,8,7941,519,8460
1427,501310,Venture Forth,0,False,Arclight Worlds,0,3,2,5
1428,501320,The Shrouded Isle,0,False,Jongwoo Kim,5,239,109,348
1429,501350,Dimension Hunter VR,0,False,Pocket Money Games,6,53,17,70
1430,501410,SOS: SPECIAL OPERATIVE STORIES,0,False,ATTACK MOUNTAIN,0,4,1,5
1431,501430,Blue Solar: Chaos War,0,False,Solar Sails Games,6,14,4,18
1432,501440,Stars,0,False,MatrixStudio,0,3,6,9
1433,501450,Puzzle Cross,0,False,Ayy Caramba Games,0,5,1,6
1434,501480,Lost Socks: Naughty Brothers,0,False,Nerf Game Co. Ltd.,6,9,3,12
1435,501500,Black Moon Chronicles,0,False,Cryo Interactive,0,4,0,4
1436,501530,SturmFront - The Mutant War: Übel Edition,0,False,Andrade Games,7,17,3,20
1437,501590,Bulletstorm: Full Clip Edition,17,False,People Can Fly,8,1579,300,1879
1438,501610,CyberLink ActionDirector 3,0,False,CyberLink,0,3,1,4
1439,500690,Secret Santa,0,True,Daniel Jonathan Bourke,7,21,1,22
1440,500710,Wild Terra Online,0,True,Juvty Worlds Ltd.,5,77,74,151
1441,500750,GI Racing 2.0,0,True,TGI Game Studio,0,3,2,5
1442,500760,Kuraburo Kai,0,False,syuuyuusya,0,1,1,2
1443,500790,Moribund,0,False,Traptics,0,1,0,1
1444,500810,Arcanum: Of Steamworks and Magick Obscura,0,False,Troika Games,8,512,98,610
1445,500870,Riddles Of The Past,0,False,MysteryTag,5,46,25,71
1446,500880,Tails,0,False,Dreamcave Studio,0,7,1,8
1447,500920,House of Alice,0,False,Cuddles and Snowflake,0,1,1,2
1448,500940,GET THE GEMS,0,False,PSY LABS,0,6,3,9
1449,500980,Endangered,0,False,"Strawberry Game Studios, LLC",0,0,5,5
1450,501020,Super Pixel Racers,0,False,"21c.Ducks Co., Ltd.",5,16,7,23
1451,501030,Extravaganza Rising,0,False,John Wizard,6,13,4,17
1452,501050,Emerland Solitaire: Endless Journey,0,True,Rainbow Games,0,1,0,1
1453,501060,C.S.S. CITADEL VR,0,False,Winged Minds,0,0,6,6
1454,501080,Fishing: Barents Sea,0,False,Misc Games,6,729,219,948
1455,501090,"Design it, Drive it : Speedboats",0,False,Performance Simulations,7,31,7,38
1456,501110,Mount Wingsuit,0,False,Ninja Whale Studios,5,47,25,72
1457,500260,Ben and Ed - Blood Party,0,False,Sluggerfly,8,247,53,300
1458,500320,A Tale of Caos: Overture,0,False,ExperaGameStudio,5,15,9,24
1459,500340,QUACK ATTACK 1985: TURBO DX EDITION,0,False,ATTACK MOUNTAIN,7,11,1,12
1460,500350,Final Fleet,0,False,Team2Bit,0,4,2,6
1461,500360,VRMultigames,0,True,Mad Triangles,0,1,0,1
1462,500420,SoulHunt,0,False,WinterCell Studios,6,24,8,32
1463,500470,Emergence ᵠ,0,False,17th Dimension,7,28,2,30
1464,500480,Fist of Physics,0,False,Midas Touch Game,5,22,10,32
1465,500500,Simple VR Video Player,0,False,simplevr.pro,6,129,45,174
1466,500550,"Save the Universe, Please!",0,False,Hodeaka Studio,0,6,1,7
1467,500580,Kitty Cat: Jigsaw Puzzles,0,False,EnsenaSoft,8,56,2,58
1468,500590,Puppy Dog: Jigsaw Puzzles,0,False,EnsenaSoft,7,21,0,21
1469,500670,Tormentor❌Punisher,0,False,E-Studio,8,136,6,142
1470,500680,Jockey Rush,0,False,Strategic Designs Ltd.,0,9,0,9
1471,500110,Glider Island,0,False,Joey Sipos,7,25,4,29
1472,500120,"Gazzel Quest, The Five Magic Stones",0,False,DemonVideogames,0,2,1,3
1473,500140,Wildlife VR,0,False,Rocket Science Club,0,2,3,5
1474,500170,Urlaubsflug Simulator – Holiday Flight Simulator,0,False,Caipirinha Games,4,7,15,22
1475,500180,Epic Flail,0,False,Noxus Limited,0,2,0,2
1476,500190,Firefight,0,False,Sean O'Connor,5,29,14,43
1477,500220,Weather Lord: Legendary Hero Collector's Edition,0,False,Yustas Games Studio,0,3,1,4
1478,499610,Copter and Sky,0,False,Fly Dream Dev,5,9,10,19
1479,499620,Ultimate Booster Experience,0,False,GexagonVR,8,146,35,181
1480,499660,Medieval Kingdom Wars,0,False,Reverie World Studios,6,881,238,1119
1481,499760,Redswood VR,0,False,Patrick Beavers,6,16,5,21
1482,499890,Aaero,0,False,Mad Fellows,8,88,10,98
1483,499900,Pulse Shift,0,False,3 Core Studio,0,1,2,3
1484,499940,Ascension VR,0,False,Temple Gates Games,5,8,7,15
1485,500090,WyVRn: Dragon Flight VR,0,False,Studio Asterism,0,2,0,2
1486,499230,SurvHive,0,False,Rocking Hamster,6,35,13,48
1487,499330,Lord Mayor,0,False,John McCann,5,6,5,11
1488,499340,Turner,0,False,Bean Boy Games,7,19,1,20
1489,499370,Tower of Archeos,0,False,Benjamin Soulé,7,14,1,15
1490,499400,The Path of Greatest Resistance,0,False,RealityRig,7,35,7,42
1491,499420,Star Fields,0,False,AG media,0,3,4,7
1492,499440,klocki,0,False,Maciej Targoni,9,1444,40,1484
1493,499460,Tomato Jones,0,False,HA Studio Ltd.,8,76,16,92
1494,499510,Dragons Never Cry,0,False,FireVector,0,5,1,6
1495,499520,The Turing Test,0,False,Bulkhead Interactive,8,3040,444,3484
1496,499540,Wake Up,0,True,Black Cell OG,0,1,1,2
1497,498720,Inklings,0,False,Applepine Games,0,4,1,5
1498,498740,Way of Redemption,0,False,Pixel Cream,0,1,0,1
1499,498830,Mustache in Hell,0,False,IdunaSoft,0,5,0,5
1500,498850,"Ortus Arena, strategy board game online, FOR FREE",0,True,Firebrush Studios,0,4,1,5
1501,498940,"WarBirds Dawn of Aces, World War I Air Combat",0,False,iEntertainment Network Inc,0,4,5,9
1502,498980,DUO,0,False,NiVision,5,17,8,25
1503,498990,Balloon Chair Death Match,0,False,Climax Studios Ltd,0,8,1,9
1504,499070,Pro Strategy Football 2016,0,False,Kerry Batts,6,10,3,13
1505,499100,Dark Parables: The Exiled Prince Collector's Edition,0,False,Blue Tea Games,7,33,5,38
1506,499110,Dark Parables: Rise of the Snow Queen Collector's Edition,0,False,Blue Tea Games,7,18,1,19
1507,499120,Dark Parables: The Red Riding Hood Sisters Collector's Edition,0,False,Blue Tea Games,7,18,2,20
1508,499140,Operator Overload,0,False,Benn Powell,7,14,1,15
1509,499210,Road Rage,18,False,Team 6,4,7,11,18
1510,498240,Batman - The Telltale Series,0,False,Telltale,8,3897,945,4842
1511,498280,Jurassic Survival,0,False,Technical Entertainment,0,2,7,9
1512,498300,Of Love And Sorrow,0,False,Niels Bauer Games,4,5,10,15
1513,498310,RPG in a Box,0,False,Justin Arnold,7,36,1,37
1514,498330,Cats are Liquid - A Light in the Shadows,0,False,Last Quarter Studios,8,390,36,426
1515,498340,Shards of Azuria,0,False,Blue Potion Games,5,37,20,57
1516,498360,Puzzle Nebula,0,False,Multiverse Games,0,2,0,2
1517,498370,Basketball Court VR,0,False,Chun Y.,0,0,2,2
1518,498380,AquaNimble,0,False,"DrinkingNails, LLC",0,6,0,6
1519,498450,A Week of Circus Terror,0,False,Richard Haraším,0,3,2,5
1520,498460,Abduction Prologue: The Story Of Jonathan Blake,0,False,Red Iron Labs,0,0,5,5
1521,498500,I Am The Hero,0,False,Crazyant,5,63,29,92
1522,498550,Depths of Dread,0,False,Mindmuscle Games,4,4,7,11
1523,498570,Extreme Forklifting 2,0,False,Devm Games,8,81,14,95
1524,498580,ASRECorp,0,False,Luke Cripps,5,5,7,12
1525,498600,MSI Electric City,0,True,Metanaut,0,0,1,1
1526,498620,The Shadowland,0,False,Bloodcraft Dev,0,3,1,4
1527,498630,Red Planet: Survive,0,False,Silent Parrot Studio,0,2,7,9
1528,498660,Mind Spheres,0,False,Microblast Games,8,59,13,72
1529,498680,In The Shadow Of The Truth,0,False,7TPGames,0,1,3,4
1530,498700,The Ember Saga: A New Fire,0,False,TSGS,0,4,2,6
1531,497850,8-Bit Hordes,0,False,Petroglyph,8,192,43,235
1532,497860,Zezenia Online,0,True,rojekti,0,1,0,1
1533,497880,Doodle WHAT?!,0,False,Binx.tv,0,2,5,7
1534,497940,Destiny of Ancient Kingdoms™,0,True,Utopia Dream Entertainment Alliance (Pty) Ltd - South Africa,0,1,2,3
1535,498000,Mushroom Crusher Extreme,0,False,Mushroom Party,0,5,2,7
1536,498030,Barnyard Mahjong 3,0,False,EnsenaSoft,0,2,1,3
1537,498040,The Hidden Dragon,0,False,EnsenaSoft,0,0,1,1
1538,498050,Mystery Of Rivenhallows,0,False,EnsenaSoft,0,1,5,6
1539,498190,Dragon Rage,0,False,Bulletproof Outlaws,6,35,9,44
1540,497400,1 Moment Of Time: Silentville,0,False,2 Monkeys,6,122,45,167
1541,497420,Pixelscape: Oceans,0,False,Hidden Nature Design,7,20,4,24
1542,497440,HOMEBOUND,0,False,Quixel,5,34,46,80
1543,497450,Blortasia,0,False,Shape Space VR,7,32,6,38
1544,497460,Mervils: A VR Adventure,0,False,VitruviusVR,7,41,6,47
1545,497470,D.N.Age,0,False,REMIMORY,5,15,17,32
1546,497480,GravPool,0,False,TinyCrease,0,1,0,1
1547,497510,Crystal Quest Classic,0,False,Game Mechanics LLC,7,18,2,20
1548,497560,Crimson Sword Saga: The Peloran Wars,0,False,David Nguyen,0,2,5,7
1549,497580,Agent Walker: Secret Journey,0,False,Brave Giant LTD,5,18,16,34
1550,497590,Sapper's bad dream,0,False,WTFOMGames,0,1,0,1
1551,497640,Trick & Treat,0,True,Rabbiton,7,13,3,16
1552,497670,Line/Dash,0,False,Gamera Interactive,6,11,3,14
1553,497680,Plates,0,False,maasgdev,6,23,9,32
1554,497700,Safety First!,0,False,JCO,7,37,7,44
1555,497710,Holobunnies: Pause Cafe,0,False,q-bit Games,0,5,2,7
1556,497720,Funfair Ride Simulator 3,0,False,Pixelsplit Simulations,5,11,13,24
1557,497730,The Wardrobe - Even Better Edition,0,False,CINIC Games,5,57,28,85
1558,497780,Recursed,0,False,Portponky,8,197,4,201
1559,497790,Ayumi: Enhanced Edition,0,False,Lord Rutsah,0,8,0,8
1560,497800,Golden Krone Hotel,0,False,Vulgat,8,140,6,146
1561,497820,Quanero VR,0,True,Laserboys3000,0,6,0,6
1562,496890,Replica,0,False,Somi,6,257,68,325
1563,496910,DrumKit VR - Play drum kit in the world of VR,0,False,0o0,5,7,9,16
1564,496930,Sumeru,0,False,BigCheeseGames,5,14,8,22
1565,496940,Second Death,0,False,Evan Wagstaff,0,2,0,2
1566,496950,The Slingshot VR,0,False,Funny Twins,5,6,7,13
1567,496960,Shoot Mania VR: Fun Zombies,0,False,Funny Twins,4,3,9,12
1568,496980,Cosmic Cavern 3671　　宇宙最大の地底最大の作戦,0,False,"Mindware Co.,Ltd.",0,4,4,8
1569,496990,Ghost Sweeper,0,False,7 Raven Studios,0,5,3,8
1570,497000,Cross Death  VR,0,False,杭州虚弥科技有限公司,0,2,3,5
1571,497020,Mystic Diary - Hidden Object,0,False,SunRay Games,5,7,4,11
1572,497040,Underground Keeper,0,False,Render System,5,9,5,14
1573,497050,Shape Shifter,0,False,PRORTUS,5,11,11,22
1574,497060,Rise,0,False,New State,0,1,0,1
1575,497080,Construct: Escape the System,0,False,Oliver Boyce,6,26,7,33
1576,497100,FootRock,0,False,diman production,5,16,7,23
1577,497150,DJ Streamer,0,False,Screaming Bee,5,11,6,17
1578,497160,Voice Again,0,False,Screaming Bee,0,1,0,1
1579,497180,Street Legal Racing: Redline v2.3.1,0,False,Invictus Games Ltd.,8,1188,208,1396
1580,497190,Pichon,0,False,Lisandro Lorea,0,3,1,4
1581,497260,Fabulous Food Truck,0,False,EnsenaSoft,0,5,3,8
1582,497270,MIGHT,0,False,Fast Forward Games,6,10,4,14
1583,497280,Wrong Dimension - The One Dimensional Platformer,0,False,StartUp Studios,0,2,2,4
1584,497300,Always Higher,0,False,AntiAnti,0,3,4,7
1585,497310,PD Particles 9,0,False,Daniel Ritchie - Squirreldome.com,0,3,1,4
1586,497360,"Gabriel Knight® 3: Blood of the Sacred, Blood of the Damned",0,False,Sierra On-Line,5,13,10,23
1587,496440,The Challenge,0,False,Atum Software,0,1,1,2
1588,496460,Life is Feudal: Forest Village,0,False,Mindillusion,5,1150,727,1877
1589,496480,Vex,0,False,Stenner Studios,5,6,4,10
1590,496490,Virtual Battlemap,0,False,Dragom,5,33,33,66
1591,496530,Pigmentone,0,False,Sliverbroom Studios,5,6,6,12
1592,496550,Noob Squad,0,False,Antonio Renna,5,90,125,215
1593,496590,Crystal Cosmos,0,False,Sea Beast Productions,0,1,1,2
1594,496610,Push The Crate: Remastered Edition,0,False,West Forest Games,0,2,2,4
1595,496620,Monster Slayers,0,False,Nerdook Productions,8,413,98,511
1596,496630,Empty Horizons,0,False,ebi-hime,7,43,6,49
1597,496640,Strange Night,0,False,Labory,5,20,23,43
1598,496650,Antihorror,0,False,HFM Games,4,9,21,30
1599,496660,Minotaur,0,False,Awesome Enterprises,0,4,5,9
1600,496670,Maze Roller,0,False,Meerkat Gaming,0,3,3,6
1601,496680,SweatShop,0,False,DUCK,4,27,70,97
1602,496690,Adventures On The Polluted Islands,0,False,Uncle Frost Team,0,1,3,4
1603,496730,Sorcerer King: Rivals,0,False,Stardock Entertainment,5,115,65,180
1604,496740,Discovering Space 2,0,False,Discovering VR,6,46,17,63
1605,496750,The Housewife,0,False,Colossal Wreck,4,15,29,44
1606,496760,The Beast Within: A Gabriel Knight® Mystery,0,False,Sierra On-Line,8,62,4,66
1607,496790,Nothin' But Net,0,False,"What Up Games, LLC",0,4,2,6
1608,496810,MegaTagmension Blanc + Neptune VS Zombies (Neptunia),0,False,IDEA FACTORY,8,413,75,488
1609,496820,Ruction: The Golden Tablet,0,False,Scott Richey,0,2,3,5
1610,496850,Brick Battalion,0,False,Scoria Studios,0,4,0,4
1611,496030,Dark Parables: The Swan Princess and The Dire Tree Collector's Edition,0,False,Eipix Entertainment,0,7,2,9
1612,496070,Geo-Fall,0,False,Argeus Games,0,1,0,1
1613,496080,"Space, VR!",0,False,James Nye,0,2,1,3
1614,496120,LaserCat,0,False,Daniel McFarline,7,27,2,29
1615,496190,Senza Peso,0,True,Kite & Lightning,7,9,2,11
1616,496230,Watching Grass Grow In VR - The Game,0,False,Pillow Head Games,0,2,3,5
1617,496250,Paddle Up,0,False,Pavel Jamal,8,135,24,159
1618,496260,Corona Blossom Vol.1 Gift From the Galaxy,0,False,Frontwing,8,66,4,70
1619,496290,Deep Dark Dungeon,0,False,GlassCats,5,8,4,12
1620,496300,Kingdom: New Lands,0,False,Noio,8,2631,395,3026
1621,496310,Momento Temporis: Light from the Deep,0,False,Burning Ice Games,5,6,6,12
1622,496320,Running Gods,0,False,Midnight Games EIRL,0,1,0,1
1623,496340,Fighting Fantasy Legends,0,False,Nomad Games,5,44,26,70
1624,496350,Supipara - Chapter 1 Spring Has Come!,0,False,minori,7,38,3,41
1625,496360,RC Racing Off Road 2.0,0,False,magnussoft,0,0,3,3
1626,496380,A Verdant Hue,0,False,Spilt Milk Studios Ltd,0,2,2,4
1627,496390,Shiny,0,False,Garage 227,0,4,4,8
1628,496400,Renoir,0,False,Black Wing Foundation,5,8,12,20
1629,495540,Dashy Square VR,0,False,Kastriot Sulejmani,0,0,1,1
1630,495550,Baskhead,0,False,VRLINES,0,2,0,2
1631,495560,Farm Manager 2018,0,False,Cleversan Software,5,475,231,706
1632,495570,ConflictCraft,0,False,Cristian Manolachi,6,39,11,50
1633,495580,Divided We Fall: Play For Free,0,True,KAVA Game Studio,5,48,41,89
1634,495600,Asteroid Fight,0,True,Katta Games,0,2,0,2
1635,495680,Overdriven Reloaded,0,False,TOMAGameStudio,6,8,3,11
1636,495700,Gabriel Knight: Sins of the Father®,0,False,Sierra On-Line,7,37,4,41
1637,495720,Intrude,0,False,Michal Kruba,8,95,17,112
1638,495730,Ghost Train VR,0,False,JDMSoftware,0,0,1,1
1639,495760,Deios II // DEIDIA,0,False,BARCHboi,6,7,3,10
1640,495770,Free Balling,0,False,Skunk Software,0,0,1,1
1641,495780,Hexoscope,0,False,Studio Binokle,7,35,8,43
1642,495820,Lil Tanks,0,False,Lead Money Games,0,5,0,5
1643,495830,Endless Labyrinth,0,False,Mike Prosser,7,12,3,15
1644,495890,Montaro,0,False,JCKSLAP,9,3739,177,3916
1645,495900,Lance A Lot: Classic Edition,0,False,Brimstone,6,23,6,29
1646,495910,Dungeon Fighter Online,0,True,Neople,6,37,15,52
1647,495960,The Secret Monster Society,0,False,Deceptive Games Ltd.,5,10,9,19
1648,495990,True Love ～Confide to the Maple～,0,False,SP-time,6,27,7,34
1649,496000,BowMage,0,False,Fusion Labz Corp.,0,3,1,4
1650,495050,Mega Man Legacy Collection 2,0,False,"CAPCOM CO., LTD",8,353,49,402
1651,495090,Evolution Planet: Gold Edition,0,False,Play Wireless,5,6,6,12
1652,495110,Enigmatis 3: The Shadow of Karkhala,0,False,Artifex Mundi,8,182,15,197
1653,495140,NARUTO: Ultimate Ninja STORM,0,False,CyberConnect2 Co. Ltd.,6,747,253,1000
1654,495200,DATH,0,False,kivoro,0,1,2,3
1655,495230,Hypnorain,0,False,KEYREAL,0,2,1,3
1656,495280,Disgaea 2 PC,0,False,"Nippon Ichi Software, Inc.",8,630,54,684
1657,495290,AccuRC 2,0,False,trasnatech,8,132,14,146
1658,495300,TrumPiñata,0,False,KittyPup Productions,5,11,7,18
1659,495320,Ancient VR coaster,0,False,Crovax Studios,5,7,5,12
1660,495390,The Wire Loop Game VR,0,False,MobileFusion Apps Ltd,0,3,2,5
1661,495520,Ping Pong League,0,True,Cover Corp.,0,1,0,1
1662,494580,STANDBY,0,False,Noclip,6,25,10,35
1663,494600,EARTH'S DAWN,12,False,oneoreight,6,34,9,43
1664,494670,TransRoad: USA,0,False,Deck13 Hamburg,5,77,70,147
1665,494700,Eliosi's Hunt,0,False,TDZ Games,5,11,7,18
1666,494720,Morphblade,0,False,Suspicious Developments,8,173,10,183
1667,494740,Police Quest™ Collection,0,False,Sierra,7,31,7,38
1668,494780,MageWorks,0,False,"Earthborn Interactive, LLC",0,5,3,8
1669,494790,Captain Curve's Intergalactic Space Adventure,0,False,CDP,0,1,0,1
1670,494810,VR: Vacate the Room (Virtual Reality Escape),0,False,hOSHI,8,149,20,169
1671,494830,ViveSpray,0,False,ciwolsey,5,42,22,64
1672,494850,VeeR Pong,0,False,Ian Slattery,0,0,1,1
1673,494960,Twisted Arrow,0,False,Phaser Lock Interactive,8,61,10,71
1674,494970,Savana,0,False,Modern Dream Ltd,0,4,2,6
1675,494980,Wondership Q,0,False,"Miracle Positive Co., Ltd.",0,4,3,7
1676,494990,Too Angry to Space,0,False,AK84C,4,6,10,16
1677,495010,Ranger of the jungle,0,False,miqu studio,0,2,1,3
1678,495030,VR Battle Grid,0,True,Fred Sauer,0,1,0,1
1679,494160,Lionheart,0,False,Shiisanmei,0,4,1,5
1680,494170,Miniature Garden,0,False,Muzintou,6,17,6,23
1681,494220,Blight of the Immortals,0,True,Iron Helmet Games,0,1,0,1
1682,494230,Heart's Medicine - Time to Heal,0,False,Blue Giraffe,8,178,14,192
1683,494290,MiDZone,0,False,NFA,5,6,4,10
1684,494310,Unbreakable Vr Runner,0,False,Miikka Åsnabrygg,7,41,1,42
1685,494350,Bowl VR,0,False,Carbon Fiber Games,4,7,11,18
1686,494360,Barrow Hill: Curse of the Ancient Circle,0,False,Shadow Tor Studios,8,55,5,60
1687,494370,Orbital Strike: Arena,0,False,Sandglass Games LLC,6,15,4,19
1688,494380,VR Boxing Workout,0,False,Wenkly Studio Sp. z o.o.,0,1,6,7
1689,494430,Praey for the Gods,0,False,No Matter Studios,8,512,88,600
1690,494440,The Amazing Shinsengumi: Heroes in Love,13,False,Dogenzaka Lab,4,15,23,38
1691,494450,Office lovers,13,False,Dogenzaka Lab,5,28,27,55
1692,494460,Dangerous Relationship,17,False,Dogenzaka Lab,5,20,22,42
1693,494470,My Butler,17,False,Dogenzaka Lab,5,25,26,51
1694,494530,Orc Hunter VR,0,True,Orc Hunter Developer Team,4,3,10,13
1695,493670,Valkyrius Prime,0,False,Iridescent Games,0,3,0,3
1696,493710,Laraan,0,False,Flynn's Arcade,5,12,6,18
1697,493720,Haven Moon,0,False,Francois Roussel,6,223,63,286
1698,493770,Awakened,0,False,Jesper Michael Petersen,0,1,2,3
1699,493780,Nightork Adventures - Beyond the Moons of Shadalee,0,True,Warptear Entertainment,0,0,1,1
1700,493790,#Archery,0,False,VRUnicorns,5,14,8,22
1701,493810,Jonah's Path,0,True,Ionut Lucian Achiricioaei,0,1,0,1
1702,493820,Rivais Em Batalha,0,False,Art Games,0,0,1,1
1703,493840,Marvel vs. Capcom: Infinite,0,False,Capcom,5,499,332,831
1704,493900,Dungeons 3,16,False,Realmforge Studios,8,3882,284,4166
1705,493920,NeverMine,0,False,Torn Banner Studios,0,1,0,1
1706,493980,Green Ranch,0,False,Palaplay,0,3,0,3
1707,494000,Anthelion,0,False,Rovio Sweden AB,0,2,2,4
1708,494020,Splash Bash,0,False,Rovio Sweden AB,0,0,1,1
1709,494040,PuppetsVR,0,False,Expo Virtualis,0,2,1,3
1710,494050,Road to your City,0,False,Yheeky Games,5,14,10,24
1711,494090,Dungeon Girl,0,False,Inu to Neko,5,6,6,12
1712,494100,ENIGMA:,0,False,Uzumeya,8,56,2,58
1713,494120,RX squad,0,False,YFYX games,0,1,1,2
1714,493180,Dynasty Feud,0,True,Kaia Studios,7,18,3,21
1715,493200,RiME,0,False,Tequila Works,8,1086,137,1223
1716,493220,After the Empire,0,False,Goatee Games,6,28,11,39
1717,493290,World VR Competition,0,False,MT Worlds,6,13,5,18
1718,493310,Requiem: Avenging Angel,0,False,Cyclone Studios,7,26,5,31
1719,493320,Killing Time,0,False,The 3DO Company,6,15,6,21
1720,493340,Planet Coaster,0,False,Frontier Developments,8,18484,2096,20580
1721,493380,ChessVR,0,False,games.Sharbit,0,6,2,8
1722,493410,Steampuff: Phinnegan's Factory,0,False,Mister Anderson,6,13,5,18
1723,493450,Wild Romance,0,False,Norn / Miel,5,25,13,38
1724,493490,City Car Driving,0,False,"Forward Development, Ltd.",6,1694,708,2402
1725,493500,Bank Limit : Advanced Battle Racing,0,False,"Tastee Beverage Studios, LLC",0,0,5,5
1726,493540,Figment,0,False,Bedtime Digital Games,8,156,30,186
1727,493580,Hidden Object - 12 in 1 bundle,0,False,Mzone,5,39,41,80
1728,493620,VR Disc Golf,0,False,FRS Game Studio,6,8,3,11
1729,493650,Deep Space Dash,0,False,Delusional Games,4,15,38,53
1730,493000,Battle Knights,0,False,Mire Studios,0,4,4,8
1731,493040,Beat Ninja,0,False,Xelphyre Games,0,3,1,4
1732,493060,Ballistic Tanks,0,False,Kirklight Games,8,97,17,114
1733,493080,Card Quest,0,False,WinterSpring Games,8,150,19,169
1734,493100,BellyBots,0,True,Grumpy Company GmbH,7,22,5,27
1735,493110,KOTH,0,False,Abbeytek Ltd,0,8,1,9
1736,492710,VR Ping Pong,0,False,Reddoll Srl,6,53,18,71
1737,492800,Shonen Idle Z,0,True,Zakos Games,0,3,2,5
1738,492850,Astroderps,0,False,Chronos VR,6,7,3,10
1739,492860,Aperion Cyberstorm,0,False,aPriori Digital,0,0,1,1
1740,492870,FIVE: Champions of Canaan,0,False,Kingdom Games,5,17,8,25
1741,492170,Planet Driller,0,False,Oryzhon Studios,0,4,5,9
1742,492180,Haimrik,0,False,Below the Game,7,22,4,26
1743,492200,CapRiders: Euro Soccer,0,False,3GoGames,0,3,0,3
1744,492220,Bohemian Killing,0,False,The Moonwalls,5,46,28,74
1745,492230,Space Hulk: Tactics,0,False,Cyanide Studio,5,195,110,305
1746,492270,The Cat! Porfirio's Adventure,0,False,Cats Who Play,5,29,20,49
1747,492280,The Agency: Chapter 1,0,False,Sapphire Dragon Productions,5,9,5,14
1748,492290,Has-Been Heroes,0,False,Frozenbyte,6,98,30,128
1749,492340,Pixel Cup Soccer 17,0,False,Batovi Games Studio,8,58,11,69
1750,492370,Affairs of the Court: Choice of Romance,0,False,Choice of Games,6,46,13,59
1751,492400,Thunder Gun: Revenge of the Mutants,0,False,Potato Interactive,0,2,1,3
1752,492410,Rogues Like Us,0,False,oddByte,6,12,4,16
1753,492430,Alteric,0,False,goonswarm,5,16,14,30
1754,492490,Zombie Apocalypse: Escape The Undead City,0,False,Anarchy Enterprises,4,10,17,27
1755,492500,Heroes of the Monkey Tavern,0,False,Monkey Stories,6,111,33,144
1756,492530,The Dark Legions,0,False,Mascot Entertainment,6,39,11,50
1757,492560,Malkia,0,False,Sports Interactive,0,1,0,1
1758,492600,Ridge,0,False,Yakovlev Vladislav,0,1,3,4
1759,492610,One Day : The Sun Disappeared,0,False,Teemo Soft,0,3,6,9
1760,491650,Reset 1-1,0,False,Panda Indie Studio,5,14,13,27
1761,491660,Assault on the Necrospire,0,True,Mike Watson,0,5,2,7
1762,491670,Stratego - Single Player,0,False,OrangeGames,6,19,8,27
1763,491700,Gotta Go,0,False,Dire Nerd Studios,5,6,4,10
1764,491710,Gun Range VR,0,False,Jeffrey Cretin,0,1,8,9
1765,491720,Nary,0,False,Khud0,0,8,0,8
1766,491770,Deformers,0,False,Ready At Dawn,4,15,35,50
1767,491790,Project Syria,0,True,Emblematic Group,0,0,1,1
1768,491800,Across The Line,0,True,Emblematic Group,0,1,5,6
1769,491830,Glow,0,False,Impetus Games,7,10,1,11
1770,491950,Orwell: Keeping an Eye On You,0,False,Osmotic Studios,8,3712,349,4061
1771,492080,Vision of Aurora Borealis,0,False,Purin Productions,6,17,7,24
1772,492090,A-Train PC Classic / みんなのA列車で行こうPC,0,False,ARTDINK,6,16,6,22
1773,492160,3D Pool,0,False,Z-Software GmbH,0,2,5,7
1774,491280,Drift Horizon Online,0,False,JDM4iK Games,4,50,85,135
1775,491330,12 Labours of Hercules V: Kids of Hellas (Platinum Edition),0,False,Jetdogs Studios,8,95,6,101
1776,491350,Way of the Red,0,False,Corey Hardman,7,23,1,24
1777,491390,Alchemist Penguin,0,False,"Foot in the Box, LLC",0,8,0,8
1778,491420,the 9th day:第九日,0,False,Lingtan Studio,0,3,1,4
1779,491440,Grim Dragons,0,False,Punkster Inc.,0,7,2,9
1780,491470,PRINCIPIA: Master of Science,0,False,tomeapp,6,25,10,35
1781,491510,Vanilla Bagel: The Roguelike,0,False,Sergey Bobrov,5,10,6,16
1782,491520,Zero-G VR,0,False,Linkus Studio,4,19,31,50
1783,491530,Notruf 112 | Emergency Call 112,0,False,Crenetic GmbH Studios,6,291,108,399
1784,491560,Momonga Pinball Adventures,0,False,Paladin Studios,5,9,8,17
1785,491580,Mahjong Destiny,0,False,EnsenaSoft,5,6,4,10
1786,490820,Fly O'Clock,0,False,Digital Melody,8,74,17,91
1787,490860,DashBored,0,False,Fading Club,7,26,2,28
1788,490870,Weird Hero,0,False,Snail-Ninja Studio,5,8,7,15
1789,490880,Robot Legions Reborn,0,False,Skyboy Games,6,13,5,18
1790,490890,Ne no Kami: The Two Princess Knights of Kyoto,0,False,Kuro Irodoru Yomiji,6,29,9,38
1791,490910,Control Craft 3,0,False,Cristian Manolachi,5,6,4,10
1792,490920,Wolfpack,0,False,Usurpator AB,8,593,50,643
1793,490930,Need to Know,0,False,Monomyth Games,6,98,26,124
1794,490950,Frost,0,False,Jérôme Bodin,8,62,6,68
1795,490980,Daily Chthonicle: Editor's Edition,0,False,Sinister Systems,6,33,10,43
1796,490990,Aiball,0,False,HFM Games,4,14,25,39
1797,491000,Gravity Cat,0,False,Quiet River,6,96,32,128
1798,491010,IN-VERT: Definitive Edition,0,False,TERNOX,6,15,6,21
1799,491020,Revenge of the Spirit: Rite of Resurrection,0,False,Absolutist Ltd.,0,1,1,2
1800,491040,Bot Vice,0,False,DYA Games,8,422,23,445
1801,491070,Shout Of Survival,0,False,Hako Games,0,2,2,4
1802,491090,Ant Queen,0,False,inVantage Technologies,5,80,54,134
1803,491100,"Human, we have a problem",0,False,Enrick Lambert,0,1,0,1
1804,491110,Duckie Dash,0,False,Blue Mana,0,4,0,4
1805,491130,Red Trigger,0,True,Bold Spirit Game Studio,7,14,2,16
1806,491160,GemBreak,0,False,Ballista Studios IVS,5,20,10,30
1807,491180,Discrepant,0,True,Incendio Software,0,5,3,8
1808,491210,LUMBERMANCER,0,False,Roger von Biersborn,7,13,3,16
1809,491220,Mr. Pumpkin Adventure,0,False,Cotton Game,6,12,4,16
1810,491240,Lil Big Invasion,0,False,Andreas Britten,7,12,0,12
1811,491260,Take Thy Throne,0,False,Charyb Games,5,33,20,53
1812,490280,Realms of Magic,0,False,Polished Games,8,202,37,239
1813,490300,Rabbit Island,0,False,Serhii Vitukhin,0,3,1,4
1814,490370,Imperium Galactica II,0,False,Digital Reality,8,163,26,189
1815,490380,Flight 787 - Advanced,0,False,idris Celik,3,3,20,23
1816,490390,神明的一天世界(God's One Day World),0,False,灰烬天国,5,7,4,11
1817,490430,Octamari Rescue,0,False,Sumo Digital,0,1,0,1
1818,490450,Tokyo 42,0,False,SMAC Games,6,125,49,174
1819,490490,Blasters of the Universe,0,False,Secret Location Inc.,8,139,17,156
1820,490510,Pixel Puzzles 2: Christmas,0,False,The Digital Puzzle Company,0,9,0,9
1821,490690,The Barbarian and the Subterranean Caves,0,False,NLB project,6,11,3,14
1822,489930,Adventures of Bertram Fiddle 2: A Bleaker Predicklement,0,False,Rumpus,8,62,14,76
1823,489940,BATTALION 1944,16,False,Bulkhead Interactive,5,5592,3457,9049
1824,490040,Child of the Wind,0,False,Freetale,7,10,1,11
1825,490080,Lock's Quest,0,False,Digital Continue,4,16,28,44
1826,490100,Quell Zen,0,False,Fallen Tree Games Ltd,7,30,0,30
1827,490160,Time Tenshi 2,0,False,Silver Cow Studio,7,32,1,33
1828,490170,Mind OVR Matter,0,False,Joe Chatfield,7,15,1,16
1829,490220,Prismata,0,True,Lunarch Studios,8,85,7,92
1830,490230,SWARMRIDERS,0,True,Walter Machado,7,21,1,22
1831,490250,Locomancer,0,True,Eric Lipschutz,7,17,4,21
1832,489570,Antisphere,0,False,"Soap Interactive, Lion Game Lion",5,22,21,43
1833,489580,AWA,0,False,OMNIDREAM CREATIONS,6,14,5,19
1834,489600,The Golf Club VR,0,False,HB Studios,5,277,130,407
1835,489610,Chicken Assassin: Reloaded,0,False,OneShark,8,132,16,148
1836,489660,Fabric,0,False,Torreng Labs,6,31,10,41
1837,489700,Battle Forever,0,False,Inferno Games,0,1,2,3
1838,489720,Conga Master,0,False,Undercoders,7,18,2,20
1839,489730,Run The Gamut,0,False,Playdev Gaming,0,1,0,1
1840,489740,Playthings: VR Music Vacation,0,False,Always & Forever Computer Entertainment,7,8,2,10
1841,489760,Demon Truck,0,False,Triger Mountain,7,26,2,28
1842,489810,BlockAid,0,False,SEGA Hardlight™,0,5,0,5
1843,489830,The Elder Scrolls V: Skyrim Special Edition,0,False,Bethesda Game Studios,9,45291,2240,47531
1844,489900,Bayla Bunny,0,False,EnsenaSoft,0,0,1,1
1845,489070,Edge of Twilight – Return To Glory,0,False,FUZZYEYES,4,4,9,13
1846,489080,Spellforge,0,False,Paper Scorpion Co.,0,1,1,2
1847,489100,MachRace,0,False,enko,0,7,1,8
1848,489110,Putty Pals,0,False,Harmonious Games,7,42,2,44
1849,489120,Sling Ming,0,False,Good Night Brave Warrior,0,5,0,5
1850,489140,Mr. Shifty,0,False,Team Shifty,8,327,38,365
1851,489160,VR Shooter Guns,0,False,Cykyria,0,4,1,5
1852,489170,Galaxy Reavers,0,False,Good Games,5,27,16,43
1853,489220,Unforgiving Trials: The Darkest Crusade,0,False,Amaterasu Software,5,7,7,14
1854,489240,Exile to Death,18,False,Aleksei Milchakov,0,0,7,7
1855,489260,Brut@l,16,False,Stormcloud Games,5,27,19,46
1856,489360,CASE: Animatronics,0,False,Walnut LLC,6,340,122,462
1857,489370,Quarantine,0,False,Sproing,5,68,40,108
1858,489380,QuiVr,0,False,Blueteak,8,363,37,400
1859,489400,The Last Look,0,False,ChaosCore UG,0,6,2,8
1860,489440,Tentacult!,0,False,Salty Sloth Studios L.L.C.,6,22,6,28
1861,489460,The Last Leviathan,0,False,Super Punk Games,5,194,99,293
1862,489470,Hide and Secret Treasure of the Ages,0,False,Anarchy Enterprises,4,11,21,32
1863,488821,Tom Clancy's Rainbow Six® Siege,0,False,Ubisoft Montreal,0,0,2,2
1864,488822,Tom Clancy's Rainbow Six® Siege,0,False,Ubisoft Montreal,0,1,1,2
1865,488823,Tom Clancy's Rainbow Six® Siege,0,False,Ubisoft Montreal,0,2,0,2
1866,488824,Tom Clancy's Rainbow Six® Siege,0,False,Ubisoft Montreal,0,1,1,2
1867,488890,GentleMoon 2,0,False,Vidas Salavejus,7,19,3,22
1868,488910,Astral Heroes,0,True,Apus Software,0,2,1,3
1869,488920,Knockout League - Arcade VR Boxing,0,False,Grab Games,6,196,53,249
1870,488950,Werewolves Within™,0,False,Ubisoft,5,55,33,88
1871,488960,Star Vikings Forever,0,False,Rogue Snail,7,11,1,12
1872,489000,The Infinite Black,0,True,Spellbook,0,0,2,2
1873,489020,iGrow Game,0,False,iDev Games,5,48,42,90
1874,489050,Whitetail Challenge,0,False,PSR Outdoors,0,2,4,6
1875,488310,Eleven Table Tennis,0,False,For Fun Labs,9,1564,74,1638
1876,488330,Highway to the Moon,0,False,Vernacular Games,0,0,1,1
1877,488350,The Karters,0,False,Pixel Edge Games,4,13,34,47
1878,488360,Vistascapes VR,0,True,Bird Man Games,5,10,14,24
1879,488440,Angeldust,0,False,Frank Lucas,0,6,3,9
1880,488460,Zeus Quest Remastered,0,False,Crazysoft Limited,0,2,0,2
1881,488480,SpaceRoads,0,False,Wurd Industries,0,2,0,2
1882,488500,The book of commands : Lost Symbol,0,False,Limpage,0,1,0,1
1883,488550,Dream Car Builder,0,False,RoKo0 (Roman Konyukhov),8,386,32,418
1884,488580,Hover 2030,0,False,Russpuppy,6,21,6,27
1885,488590,Armed Against the Undead,0,False,Rank17,7,20,2,22
1886,488660,Just Deserts,0,False,Vifth Floor,8,122,28,150
1887,488690,MX Nitro: Unleashed,0,False,Saber Interactive,7,18,3,21
1888,488730,God's Trigger,0,False,One More Level,6,81,32,113
1889,488760,Left-Hand Path,0,False,Strange Company,8,88,14,102
1890,488770,Her Majesty's SPIFFING,0,False,Billy Goat Entertainment Ltd,6,137,39,176
1891,488790,South Park™: The Fractured But Whole™,0,False,Ubisoft San Francisco,6,6325,1779,8104
1892,487720,Agony,0,False,Madmind Studio,5,345,438,783
1893,487730,Hat Trick Header,0,False,no-pact,0,4,0,4
1894,487770,Hoops VR,0,False,Wizard Games Inc,6,25,7,32
1895,488020,Day of Destruction,0,False,"SynaptixGames, LLC",0,1,1,2
1896,488040,VR Toolbox: 360 Desktop,0,False,MyDream Interactive Inc.,6,50,20,70
1897,488070,Escargot Kart,0,False,Caps Lock Solutions,0,3,4,7
1898,488080,Taxi,0,False,petraguardsoftware.com,0,1,0,1
1899,488150,Octoshield VR,0,False,Liana Pigeot,5,16,8,24
1900,488210,JDM Tuner Racing,0,False,JDM4iK,5,18,18,36
1901,488220,Valcarta: Rise of the Demon,0,False,Blacksword Games,0,2,0,2
1902,488280,Gun Done,0,False,AZAMATIKA,8,88,17,105
1903,488300,Infinite Air with Mark McMorris,0,False,HB Studios,6,147,37,184
1904,487330,Totally Unbalanced,0,True,Isojumper,5,13,7,20
1905,487350,Pirate Pop Plus,0,False,dadako,7,12,0,12
1906,487370,Akin,0,False,ThinkOfGames,5,14,7,21
1907,487430,KARAKARA,0,False,calme,8,190,15,205
1908,487530,Simple Ball: Extended Edition,0,False,Antizero company,4,5,8,13
1909,487580,Ludo Supremo,0,False,EnsenaSoft,0,5,4,9
1910,487590,Pepe Porcupine,0,False,EnsenaSoft,0,7,1,8
1911,487600,Puzzles Under The Hill,0,False,EnsenaSoft,0,6,1,7
1912,487630,Lantern,0,False,Storm in a Teacup,5,7,7,14
1913,486780,Fruit Ninja VR,0,False,Halfbrick Studios Pty Ltd,8,376,91,467
1914,486810,House of Snark 6-in-1 Bundle,0,False,Alawar Entertainment,7,33,8,41
1915,486850,Card of spirits(卡灵),0,False,RMking,5,5,5,10
1916,486890,Gear Gauntlet,0,False,Drop Dead Interactive,0,1,0,1
1917,486940,Handball Action Total,0,False,netmin games,0,5,0,5
1918,486990,Jump Stars,0,False,Jamit Games,0,2,4,6
1919,487000,Quest Hunter,0,False,2 Zombie Games,8,467,106,573
1920,487020,Fantasy Mosaics 14: Fourth Color,0,False,Andy Jurko,7,15,1,16
1921,487030,Beasts Battle,0,False,Greenolor Studio,6,11,4,15
1922,487040,88 Heroes,0,False,Bitmap Bureau,6,11,4,15
1923,487120,Citadel: Forged with Fire,0,False,Blue Isle Studios,5,1879,981,2860
1924,487160,Trials of Azra,0,False,Onion Core,7,42,3,45
1925,487180,The Lords of the Earth Flame,0,False,Rhino Games,5,11,6,17
1926,487220,Freebie,0,False,Free Games Info,6,115,47,162
1927,487250,Spaera,0,False,Blazing Orb LLC,0,5,2,7
1928,486290,Waddle Home,0,False,Archiact,7,21,0,21
1929,486300,Plan Z Chapter 1,0,False,Kongmeng Yang,4,3,8,11
1930,486310,Meadow,0,False,Might and Delight,8,1814,191,2005
1931,486320,Orbit: Satellite Defense,0,False,Bluish-Green Productions,0,1,0,1
1932,486350,Square Arena,0,False,Hepta Games,0,2,0,2
1933,486360,Timore Inferno,0,False,Vidas Salavejus,0,7,1,8
1934,486370,Pinball Evolution VR,0,False,Pinball Evolution VR,7,21,5,26
1935,486380,Shigatari,0,False,Super Legit Games,8,94,2,96
1936,486410,Biosys Inc,0,False,Fire Game Studios,0,3,1,4
1937,486440,Mosh Pit Simulator,0,False,Sos Sosowski,6,21,8,29
1938,486470,Derelict Redux,0,False,Floor59Games,5,8,8,16
1939,486480,Tales of Destruction,0,False,Tero Lunkka,4,4,11,15
1940,486490,Witan,0,True,Imigea Ltd,0,6,3,9
1941,486500,Spooky Heroes,0,False,Gaweb Studio,0,0,2,2
1942,486510,TOKYO WARFARE,0,False,Pablo Vidaurre Sanz,8,153,26,179
1943,486540,Townsmen,0,False,HandyGames,5,24,12,36
1944,486550,The Caretaker - Dungeon Nightshift,0,False,bluebox interactive,0,0,3,3
1945,486630,Toxic Terror,0,False,Fascimania,0,4,1,5
1946,486640,Cheaters Blackjack 21,0,False,BlackOpzFX,0,2,3,5
1947,486650,Potato Thriller,0,False,Samer Khatib (Snowconesolid Productions),8,194,48,242
1948,486660,Super Mixtape,0,False,Polygrammatic Limited,0,4,0,4
1949,486670,Easy French™ Platinum,0,False,Individual Software,0,2,3,5
1950,486690,Pastelia Stories,0,False,Maru Project Develop Team,0,4,4,8
1951,486720,Bastard Bonds,0,False,Bigfingers,8,338,40,378
1952,486760,Master Of Marbles,0,False,Steve Fox,0,0,1,1
1953,485890,Summer Sale,0,False,Ductape studio,5,188,188,376
1954,485900,Hardware Engineers,0,False,Green127,8,121,23,144
1955,485920,Neon Warp,0,False,Axel Sonic,5,9,6,15
1956,485950,Rise of the Ancients,0,False,Talentplace,4,18,48,66
1957,485970,Cyber Sentinel,0,False,mindhelix.pl,7,10,1,11
1958,485980,Syrian Warfare,0,False,Cats Who Play,8,793,151,944
1959,486020,Hero,0,False,Bakershah Games,0,2,2,4
1960,486120,Escape The Past,0,False,3DDUO,0,1,3,4
1961,486130,Best Buds vs Bad Guys,0,False,Reset Games Ltd,0,2,3,5
1962,486140,9Grids VR,0,False,Klexian,0,2,1,3
1963,486150,Radical Spectrum: Volume 1,0,False,Autonomic Interactive,4,6,13,19
1964,486170,Bathory - The Bloody Countess,0,False,Absolutist Ltd.,0,1,5,6
1965,486180,The Penguin Factory,0,False,Battenberg Software,0,4,0,4
1966,486230,Con Amore,0,False,Team Taju,6,7,3,10
1967,485340,The Orchard of Stray Sheep,0,False,Namaage,6,14,5,19
1968,485350,Winter Novel,0,False,DeXP,5,58,26,84
1969,485360,Disgraced,0,False,Corrosive Studios LLC,8,46,9,55
1970,485370,Mad Combat Marines,0,False,Freeze Nova,5,82,39,121
1971,485380,Welcome to the Game,18,False,Reflect Studios,8,1059,232,1291
1972,485390,Machine Made: Rebirth,0,False,Proteus Studios,0,0,2,2
1973,485430,NAL Is Alive,0,False,Chequered Ink Ltd.,0,2,2,4
1974,485460,The Banner Saga 3,0,False,Stoic,8,691,154,845
1975,485490,Dungeon Journey,0,False,Carbomb Software,8,56,13,69
1976,485500,Smithy,0,False,David Mulder,5,14,7,21
1977,485570,Milford Heaven - Luken's Chronicles,0,False,CGGAMES,0,4,0,4
1978,485590,Citadel,0,False,Magisterion,0,2,1,3
1979,485600,OESE,0,True,Alec Smith,7,28,5,33
1980,485620,Pick a Hero,0,False,vikingfabian.com,6,22,8,30
1981,485630,Brazed,0,False,Vladimir Maslov,5,8,10,18
1982,485640,Genius Greedy Mouse,0,False,Space Fractal,6,12,5,17
1983,485650,Campaign Clicker,0,True,Springloaded,0,2,3,5
1984,485660,Karma Miwa,0,False,Space Fractal,0,4,5,9
1985,485670,Mini Golf Arena,0,False,Evoluta Studio,5,42,63,105
1986,485680,sphereFACE,0,False,VoxelStorm,7,18,1,19
1987,485690,Hope Lake,0,False,Far Mills,5,131,68,199
1988,485730,Shift,0,False,Black Lime Studio,6,49,15,64
1989,485750,Magnetta,0,False,Heliocentric Studios,5,8,6,14
1990,485790,JOLT: Super Robot Racer,0,False,Cooply Solutions,0,1,2,3
1991,485800,Runeous: Part One,0,True,Novel Tea Games,0,1,1,2
1992,485820,e-River Cabin Journal,0,False,Wilderness Journal Games,5,19,20,39
1993,485830,Star Merc,0,False,D247 Games,5,5,7,12
1994,485860,Impossible Quest,0,False,Axel Sonic,5,43,38,81
1995,485870,Super Duper Party Pooper,0,False,K Bros Games,8,104,22,126
1996,485880,L U N E,0,False,Isaac Cohen,7,37,2,39
1997,484930,Beekyr Reloaded,0,False,KaleidoGames,7,14,3,17
1998,484950,Evil Maze,0,False,ZOV GAME STUDIO,5,86,50,136
1999,484990,Alveari,0,False,BeehiveBob,0,1,0,1
2000,485000,Cthulhu Realms,0,True,Wise Wizard Games,5,7,4,11
2001,485030,PLANET ALPHA,0,False,Planet Alpha ApS,6,125,32,157
2002,485040,Nurse Love Addiction,0,False,KOGADO STUDIO,8,121,20,141
2003,485080,Megapolis,0,False,Lonely Troops,6,19,7,26
2004,485110,PlanetFate,0,False,Aaron Matthies,7,12,2,14
2005,485120,Frog Climbers,0,False,TeamCrew,7,35,2,37
2006,485150,Web Designer 12 Premium Steam Edition,0,False,MAGIX Software GmbH,0,2,3,5
2007,485160,Black Hole Hazard,0,False,Superthumb,6,7,3,10
2008,485230,HALP!,0,True,Fun Bits,0,1,1,2
2009,485240,Push For Emor,0,False,Lupus Solus Studio,5,14,12,26
2010,485260,Talent Not Included,0,False,Frima Studio,0,3,1,4
2011,485270,Arachnophobia,0,False,IgnisVR,0,1,7,8
2012,485290,Vermillion Watch: Moorgate Accord Collector's Edition,0,False,Eipix Entertainment,7,10,0,10
2013,485310,Head Shot,0,False,Indie Game Group,5,12,13,25
2014,485330,Star Drifter,0,False,Nostalgia Hound,4,15,31,46
2015,484830,Deep Blue 3D Maze in Space,0,False,Ice Code Games,5,8,4,12
2016,484870,Battle Dome,0,False,Bad Bird Studios,8,354,45,399
2017,484890,Crazy Otto,0,False,Extend Mode,0,6,3,9
2018,484900,Aven Colony,0,False,Mothership Entertainment LLC,6,599,186,785
2019,483950,SMILE GAME BUILDER,0,False,SmileBoom Co.Ltd.,8,98,13,111
2020,483960,Purino Party,0,False,Frontwing,5,93,58,151
2021,483970,Directionless,0,False,Zach Tsiakalis-Brown,8,43,10,53
2022,483980,Mad Father,0,False,sen,9,1267,32,1299
2023,484350,VRZ: Torment,0,False,StormBringer Studios,6,104,39,143
2024,484390,Hanger World,0,False,A Small Game AB,0,8,0,8
2025,483490,Circuitous ®,0,False,The Owl Prophecy,0,5,0,5
2026,483680,PolyDome,0,True,Plan8,0,1,0,1
2027,483770,Autobahn Police Simulator 2,0,False,Z-Software,5,58,74,132
2028,483820,Four Realms,0,False,Hugebot!,0,1,0,1
2029,483850,Guns N' Boxes,0,False,LightArrow Games,5,9,4,13
2030,482390,The Night Cafe: A VR Tribute to Vincent Van Gogh,0,True,Borrowed Light Studios,0,2,0,2
2031,482450,Nitroplus Blasterz: Heroines Infinite Duel,0,False,EXAMU,8,240,29,269
2032,482460,Reverence: The Ultimate Combat Experience,0,False,Mantis Studios,0,3,2,5
2033,482890,Fantasy Kingdom Simulator,0,False,SimProse Studios,3,5,25,30
2034,482920,Hero Zero,0,True,Playata GmbH,6,8,3,11
2035,481950,Emily: Displaced,0,False,Bossa Studios,0,6,0,6
2036,482210,Quarterback SNAP,0,False,River Studios,0,4,2,6
2037,482300,Investigator,0,False,AdroVGames,5,158,80,238
2038,482330,Legends of the Universe - StarCore,0,False,LunarCore Games,5,20,12,32
2039,481510,Night in the Woods,0,False,Infinite Fall,8,7593,468,8061
2040,481600,Finding Hope,0,False,Falling Star Studio,5,13,6,19
2041,481870,Mini Thief,0,False,Stranga,5,85,46,131
2042,481110,The Bunker,0,False,Splendy Interactive,5,257,126,383
2043,481180,System Crash,0,False,Rogue Moon Studios,8,136,28,164
2044,481190,Stable Orbit - Build your own space station,0,False,Codalyn,5,105,100,205
2045,480480,Slash or Die,0,False,ClickGames,8,49,12,61
2046,480490,Prey,0,False,Arkane Studios,8,11972,1242,13214
2047,480500,Dogfight Elite,0,False,Echoboom S.L.,6,10,4,14
2048,480640,Pathfinder Adventures,0,False,Obsidian Entertainment,5,217,132,349
2049,480650,Yu-Gi-Oh! Legacy of the Duelist,0,False,Other Ocean Interactive,8,1407,306,1713
2050,480690,Inbound,0,False,Gyoza Games LLC,7,31,3,34
2051,480710,Moatboat,0,False,Moatboat,0,0,1,1
2052,480770,Dreamals,0,False,"XINESS Co,. Ltd.",0,1,0,1
2053,480900,Slap Village: Reality Slap,0,False,MonkeyToons,5,15,13,28
2054,479990,Dungeons & Darkness,0,False,Yamiuchi Project,5,35,19,54
2055,480410,Mitch: Berry Challenge,0,False,Boidae Games,0,5,1,6
2056,480450,Floppy Heroes,0,False,Matthew Kania,8,91,3,94
2057,479100,Music Wars Empire,0,False,Antuan Johnson,5,40,40,80
2058,479110,Hunter's Legacy,0,False,Lienzo,7,8,2,10
2059,479130,ESEA,0,True,ESEA,5,67,31,98
2060,479140,Framed Wings,0,False,Kodama Games,7,13,2,15
2061,479150,BoX -containment-,0,False,Memorazer Production,0,2,0,2
2062,479170,Drunk Wizards,0,False,Strongbow,0,0,1,1
2063,479180,Space Universe,0,False,Universe,0,0,5,5
2064,479200,Champions of Odin,0,False,Hybris Studios,0,1,1,2
2065,479310,Doodler,0,True,SolarByte,0,3,0,3
2066,479330,Crazy Stone Deep Learning -The First Edition-,0,False,UNBALANCE Corporation,6,12,5,17
2067,478950,V ARRR,0,False,Blackjard Softworks,5,42,21,63
2068,478960,Clickteam Fusion 2.5 Free Edition,0,True,Clickteam,0,1,0,1
2069,478980,Mansions of Madness,0,True,Fantasy Flight Games,0,7,1,8
2070,479000,IrreVRsible,0,False,raptor lab,7,24,6,30
2071,479010,Kodon,0,False,TenkLabs,6,111,37,148
2072,479020,Pirates of the Polygon Sea,0,False,Praxia Entertainment,5,34,21,55
2073,479040,Metamorphic,0,False,Jeremy Slavitz,5,10,6,16
2074,478210,BUDDY,0,False,Hoshko,4,6,13,19
2075,478000,Qantas VR,0,True,Start VR,0,0,1,1
2076,478010,ABC Coloring Town,0,False,EnsenaSoft,0,3,5,8
2077,478020,Old School 8-in-1 bundle,0,False,Zoom2Games,0,2,0,2
2078,477720,Toricky,0,False,Atelier Melon-Kissa,0,4,3,7
2079,477730,Eador. Imperium,0,False,Snowbird Games,6,320,123,443
2080,477740,Zero Escape: The Nonary Games,0,False,"Spike Chunsoft Co., Ltd.",9,1785,84,1869
2081,477750,Thirty Years' War,0,False,Ageod,5,12,9,21
2082,477770,Ride 2,0,False,Milestone S.r.l.,8,575,118,693
2083,477800,Piñata,0,True,Nexus Interactive Arts,0,0,1,1
2084,477870,Yomawari: Night Alone,0,False,"Nippon Ichi Software, Inc.",8,329,79,408
2085,477900,Lord of Dwarves,0,False,Stellar Sage Games,7,40,7,47
2086,477910,Wanderer of Teandria,0,False,Silentplaygames,0,2,0,2
2087,477010,10 Minute Tower,0,False,Team17 Digital Ltd,0,1,2,3
2088,477120,Train Chase,0,False,Rhine Games,0,1,0,1
2089,477130,Surge,0,True,House of Secrets,0,4,0,4
2090,477140,SparkDimension,0,False,Asixa,0,1,1,2
2091,477160,Human: Fall Flat,0,False,No Brakes Games,9,18025,896,18921
2092,477170,Chamber 19,0,False,Deepak M.,5,16,8,24
2093,477180,Shard Games,0,False,Novation Games,5,4,6,10
2094,477190,Epic Snowday Adventure,0,False,Verge of Brilliance LLC,0,3,0,3
2095,477200,Descent: Road to Legend,0,True,Fantasy Flight Games,0,8,0,8
2096,477270,Lightblade VR,0,False,Andreas Hager Gaming,8,411,97,508
2097,477290,Magma Tsunami,0,False,StrangeLight Games,5,7,4,11
2098,477310,Space Hole 2016,0,False,Sam Atlas,7,39,2,41
2099,476620,Call of Duty®: WWII,18,False,Sledgehammer Games,6,1250,382,1632
2100,476650,The Silver Case,0,False,GRASSHOPPER MANUFACTURE INC.,8,215,40,255
2101,476670,Emberdoom,0,False,"Loud King Studios, LLC",0,2,1,3
2102,476700,Island 359™,0,False,"CloudGate Studio, Inc.",6,233,73,306
2103,476710,MechaGore,0,False,imaginite Ltd,0,1,7,8
2104,476920,Amulet of Dreams,0,False,Mysterytag,5,30,33,63
2105,476240,KNIGHTS,0,False,Arzola's,8,297,14,311
2106,476370,MAGATAMA Earrings,0,False,TinyAssociatesBand,0,1,1,2
2107,476420,Heart of Crown PC,0,False,illuCalab,5,84,38,122
2108,476430,SwingStar VR,0,False,Computer Lunch,0,9,0,9
2109,476450,So Much Blood,0,False,Zachary Berenger,5,17,8,25
2110,476460,Picross Touch,0,True,Jon Gallant,7,11,0,11
2111,476490,Choice of the Pirate,0,False,Choice of Games,8,81,7,88
2112,476510,Cally's Trials,0,False,VDO Games,7,14,3,17
2113,476530,Children of a Dead Earth,0,False,"Q Switched Productions, LLC",8,350,36,386
2114,475960,Bombslinger,0,False,Mode4,7,17,4,21
2115,476000,Slightly Magic - 8bit Legacy Edition,0,False,Colin Jones & The Potassium Frog,0,6,0,6
2116,476020,Reflection of Mine,0,False,Redblack Spade,5,29,18,47
2117,476030,Johnny Graves—The Unchosen One,0,False,Stupid Stupid Games,0,2,5,7
2118,475240,ORCS,0,False,Pixel vs Pixel,6,135,34,169
2119,475490,Major\Minor,0,True,Klace,6,290,76,366
2120,475520,Holodaze,0,False,Sysdia Games,6,7,3,10
2121,475530,Go Go Electric Samurai,0,True,Hexagon Games,0,1,0,1
2122,475550,Beholder,1,False,Warm Lamp Games,8,1689,413,2102
2123,475620,MOAI 4: Terra Incognita Collector’s Edition,0,False,Toyman Interactive,0,8,1,9
2124,475630,Crush Online,0,False,Joy Impact,5,14,8,22
2125,474810,Dorke and Ymp,0,False,Norse,0,3,3,6
2126,474830,Time in Time,0,False,ErayTek,6,12,4,16
2127,474880,Second Coming,0,False,Seen in a Dream,0,2,1,3
2128,474890,Uncrewed,0,False,Quite Different Mechanics,6,69,25,94
2129,474910,The Mahjong Huntress,0,False,Nawia Games,5,22,17,39
2130,474960,Quantum Break,0,False,Remedy Entertainment,8,3531,744,4275
2131,474980,Cat President ~A More Purrfect Union~,0,False,"Oh, a Rock! Studios",8,69,8,77
2132,475050,bloxyz,0,False,Svution,0,2,3,5
2133,475080,Cavernus,0,False,frozenen,0,1,3,4
2134,475090,Project Remedium,0,False,Atomic Jelly,4,8,15,23
2135,475150,Titan Quest Anniversary Edition,0,False,Iron Lore Entertainment,8,4779,504,5283
2136,475190,Scanner Sombre,0,False,Introversion Software,8,954,105,1059
2137,474620,Giga Girl,0,False,Outgunned Games,7,9,1,10
2138,474730,Airship Asunder,0,False,Sally Rough LLC,0,4,2,6
2139,474750,Reigns,0,False,Nerial,8,1983,303,2286
2140,473910,The Nest,0,True,invrse studios,5,88,55,143
2141,473920,Corinne Cross's Dead & Breakfast,0,False,bad chalk,8,104,1,105
2142,473950,Manifold Garden,0,False,William Chyr Studio,9,1335,53,1388
2143,473970,Zombie City Defense 2,0,False,Mozg Labs,5,52,32,84
2144,474010,The NADI Project,0,True,Monkeys Tales Studio,0,1,4,5
2145,474020,Ragnorium,0,False,Vitali Kirpu,6,178,48,226
2146,474050,Candy Blast,0,False,White Rabbit Games,0,3,3,6
2147,474210,BUTCHER,0,False,Phobia Game Studio,8,421,48,469
2148,474240,Journey to the Center of the Earth,0,False,Frogwares,4,3,11,14
2149,473450,The Narrator Is a DICK,0,False,Adam DeLease,6,63,21,84
2150,473460,Memory Oblivion Box,0,False,DreaMory,0,3,0,3
2151,473470,Purgatory,0,False,Eduard Mirica,5,41,30,71
2152,473480,Miko Mole,0,False,EnsenaSoft,0,2,1,3
2153,473510,Gal-X-E,0,False,NodziGames,7,15,3,18
2154,473520,Autumn,0,False,Nuno Donato,5,7,7,14
2155,473530,Slime-san: Superslime Edition,0,False,Fabraz,7,27,2,29
2156,473540,Raise Your Own Clone,0,False,CoaguCo Industries,0,1,5,6
2157,473550,SnowBall FPS,0,False,khos85,0,0,1,1
2158,473560,Cosmic Dust & Rust,0,False,16bit Nights,5,59,56,115
2159,473610,Shock Tactics,0,False,Point Blank Games,4,12,26,38
2160,473670,The Dolls: Reborn,0,False,HUSH Interactive,5,28,30,58
2161,473690,Absolver,0,False,Sloclap,6,4522,1798,6320
2162,473720,Mutant Mudds Super Challenge,0,False,Renegade Kid LLC,7,11,0,11
2163,473770,BallisticNG,0,False,Neognosis,9,705,37,742
2164,473780,Splitter Critters,0,False,RAC7,0,8,1,9
2165,473810,Killbot,0,False,nobodyshot,4,7,16,23
2166,473840,Diib's Dilemma,0,False,Random Thoughts Enterainment,7,12,2,14
2167,473050,UnderWater Adventure,0,False,Torii-Games,0,0,1,1
2168,473140,BomberZone,0,False,Dracula Bytes,0,2,2,4
2169,472680,Elisa: The Innkeeper - Prequel,0,True,Neoclassic Games,5,8,5,13
2170,472690,Sombrero: Spaghetti Western Mayhem,0,False,PixelMetal,0,6,1,7
2171,472740,Ghrian,0,False,GHRIAN STUDIO,0,0,3,3
2172,472770,HELP: THE GAME,0,False,Sports Interactive,0,7,0,7
2173,472830,Ke-Tsu-No-Ana,0,False,Yusuke Uemura,0,1,2,3
2174,472870,Higurashi When They Cry Hou - Ch.3 Tatarigoroshi,0,False,07th Expansion,8,282,3,285
2175,472420,"Duke Grabowski, Mighty Swashbuckler",0,False,Venture Moon Industries,8,71,12,83
2176,471700,Greedy Guns,0,False,Tio Atum,5,13,6,19
2177,471720,K Station,0,True,Maya Games,0,2,0,2
2178,471730,Rocket Ski Racing,0,False,nocanwin,5,6,4,10
2179,471770,"In Case of Emergency, Release Raptor",0,True,"Arcen Games, LLC",0,4,2,6
2180,471810,Death Squared,0,False,SMG Studio,8,145,11,156
2181,471920,Pan-Pan,0,False,Spelkraft,8,69,11,80
2182,472060,Ortus Regni,0,True,Jon Sudbury Games,0,3,0,3
2183,471200,Melody,0,False,Verge of Brilliance LLC,0,3,0,3
2184,471220,Don't Drop the Bass,0,False,RadishBox,0,2,0,2
2185,471260,Osozaki 遅咲き Late Blooming - First,0,False,Kurisu no Patto,6,15,6,21
2186,471270,Leave The Nest,0,False,Kaio Interactive,0,5,2,7
2187,471330,VERSUS SQUAD,0,False,DiezelPower,6,146,37,183
2188,471380,Urban Pirate,0,False,Baby Duka,5,9,5,14
2189,471400,Space Jammers,0,False,Spread Shot Studios LLC,0,3,0,3
2190,471550,Nine Parchments,0,False,Frozenbyte,6,743,197,940
2191,471630,Rexodus: A VR Story Experience,0,True,Steelehouse VR Studios,0,2,0,2
2192,471640,.EXE,0,False,"Two Man Army Games, L.L.C",0,5,2,7
2193,471660,Kingspray Graffiti VR,0,False,Andrew Bates,8,367,64,431
2194,470740,Demolish & Build 2017,0,False,Noble Muffins,6,68,21,89
2195,470760,Antiflux,0,True,UAA Software,0,4,2,6
2196,470780,She Remembered Caterpillars,0,False,jumpsuit entertainment UG (haftungsbeschränkt),8,59,1,60
2197,470890,WarFire,0,False,D&K Games Studio,0,0,4,4
2198,471010,Seven: Enhanced Edition,0,False,IMGN.PRO,6,333,97,430
2199,471160,Moonshot Galaxy™,0,False,Liftoff Labs,5,15,10,25
2200,471170,Romopolis,0,False,Lonely Troops,6,22,7,29
2201,470210,Rocketbirds 2 Evolution,0,False,Ratloop Asia,6,40,12,52
2202,470220,UNO,0,False,Ubisoft Entertainment,6,11404,4195,15599
2203,470260,Event[0],0,False,Ocelot Society,6,746,225,971
2204,470270,Tribal Pass,0,False,Tribe Tea,6,42,17,59
2205,470280,Lost Route,0,False,Imbanova Entertainment Inc.,4,4,15,19
2206,470300,Winged Sakura: Demon Civil War,0,False,WINGED SAKURA GAMES,6,37,11,48
2207,470310,TROUBLESHOOTER: Abandoned Children,0,False,Dandylion,8,1534,92,1626
2208,470440,Matris,0,False,Leaghorn,7,11,0,11
2209,470450,Where's My Helmet?,0,False,Mega Boss Game Studio,7,9,2,11
2210,470470,Birdsketball,0,False,Waynetron,7,24,0,24
2211,470480,Angel Express [Tokkyu Tenshi],0,False,Easy Game Station,0,7,2,9
2212,470490,RollerGirls From Beyond,0,False,Stonepunk Studios,5,7,4,11
2213,470580,In The Shadows,0,False,Colorspace Studio,7,16,2,18
2214,470590,moto RKD dash SP,0,False,rkd.zone,7,23,3,26
2215,469730,Super Mega Neo Pug,0,False,SnowFlame,8,208,27,235
2216,469790,Linelight,0,False,My Dog Zorro,8,219,5,224
2217,469890,Space Codex,0,False,takk,8,64,12,76
2218,469900,Paradox Paradigm,0,False,Josh,5,5,6,11
2219,469920,hackmud,0,False,Drizzly Bear,6,391,112,503
2220,469990,NEKOPALIVE,15,True,NEKO WORKs,0,4,3,7
2221,470020,"SnarfQuest Tales, Episode 1: The Beginning",0,False,Cellbloc Studios,0,0,1,1
2222,470030,Just Bones,0,False,Elephant Games,0,1,0,1
2223,470040,Spellgear,0,True,SkyRiver Studios,5,8,9,17
2224,470060,1917 - The Alien Invasion DX,0,False,Andrade Games,6,34,10,44
2225,470090,Quantum Replica,0,False,ON3D Studios,7,13,2,15
2226,470140,Funklift,0,False,Mostly Harmless Games,0,1,0,1
2227,470170,Evangeline™,0,False,Raconteur Games,5,8,9,17
2228,469550,Bambino Rally 3,0,False,Play Publishing,0,4,1,5
2229,469610,Rick and Morty: Virtual Rick-ality,0,False,Owlchemy Labs,6,948,320,1268
2230,469650,Disney Movies VR,0,True,Walt Disney Studios,0,0,1,1
2231,469710,Shattered Throne,0,False,Checkmark Games,6,16,5,21
2232,469720,Monsters' Den: Godfall,0,False,Monstrum,8,249,39,288
2233,468740,Snow Fortress,0,False,Mythical City Games,7,18,3,21
2234,468780,The Concourse,0,False,"A & B Game Studios, LLC",0,6,0,6
2235,468800,Arkshot,0,False,Code Avarice,5,25,11,36
2236,468820,Titans of Space PLUS,0,False,DrashVR LLC,8,121,9,130
2237,468920,Ultimate Fishing Simulator,0,False,Bit Golem,8,1102,148,1250
2238,468930,Phantaruk,0,False,Polyslash,5,28,17,45
2239,468490,Neon Space,0,False,EGAMER,5,81,36,117
2240,468530,A Date in the Park,0,True,Cloak and Dagger Games,7,30,6,36
2241,468560,Blind Trust,0,True,Viswanath Atlu,5,10,14,24
2242,468570,De-Void,0,False,Pulsetense Games,5,16,21,37
2243,468650,Super ComboMan: Smash Edition,0,False,Interabang Entertainment,0,0,1,1
2244,468700,NVIDIA® VR Funhouse,0,True,Lightspeed Studios™,7,12,2,14
2245,467890,Garage Drummer VR,0,False,Blazing Tree Studio,5,14,10,24
2246,467900,SWORDY,0,False,Frogshark,5,32,22,54
2247,467910,EPΘCH,0,False,Nick Everlith,5,16,9,25
2248,467930,SMASHING THE BATTLE,0,False,STUDIO HG,6,141,40,181
2249,467940,Memoir En Code: Reissue,0,False,Kalopsia Games,0,7,0,7
2250,467950,Survive in Space,0,False,EGAMER,6,34,13,47
2251,467960,Home Behind,0,False,TPP Studio,5,100,88,188
2252,467990,Versus: Battle of the Gladiator,0,False,Netker Inc.,5,73,37,110
2253,468050,The Last Time,0,False,Big Cow Studios,8,81,4,85
2254,468070,90 Minute Fever - Football (Soccer) Manager MMO,0,True,Isokron,5,42,26,68
2255,468080,Occurrence at JCR Outpost,0,False,Brandon Brizzi,0,1,1,2
2256,468100,Aqua Moto Racing Utopia,0,False,Zordix AB,6,39,11,50
2257,468110,Rescuties! VR,0,False,"mode of expression, LLC",7,11,0,11
2258,468130,Nebula,0,False,Szekretar,0,3,0,3
2259,468150,Trap House,0,False,Hive Mind Studios,0,3,2,5
2260,468160,Ancient Go,0,False,Hart Laboratories LLC,5,24,21,45
2261,468170,AcidPunk : Echoes of Doll City,0,False,GaelDK,7,15,2,17
2262,468240,VR Regatta - The Sailing Game,0,False,MarineVerse,8,60,10,70
2263,468250,Warfare Online,0,False,Con Artist Games,6,77,26,103
2264,468310,She Wants Me Dead,0,False,Hello There AB,6,18,5,23
2265,468320,Mini Golf Mundo,0,False,EnsenaSoft,0,2,3,5
2266,468330,HIVE: Altenum Wars,0,False,Catness Game Studios,0,4,1,5
2267,468350,Hexaverse,0,False,Stefan Elsen,0,1,1,2
2268,467470,Shoot Shoot Mega Pack,0,False,Actual Humans,7,13,0,13
2269,467480,C O S M,0,False,Dynamoid,0,5,4,9
2270,467490,GRAVEN The Purple Moon Prophecy,0,False,Orchid Games,7,20,2,22
2271,467520,Power & Revolution,0,False,Eversim,5,122,133,255
2272,467570,TITANS: Dawn of Tribes,0,False,34BigThings srl,4,42,72,114
2273,467650,Demolition,0,False,khos85,0,1,0,1
2274,467660,Paranormal Activity: The Lost Soul,18,False,VRWERX,6,316,105,421
2275,467710,Santa Girls,0,False,Dharker Studio,7,8,2,10
2276,467720,Roomie Romance,0,False,Dharker Studio,5,18,9,27
2277,467750,Chromo XY,0,False,Dharker Studio,6,10,4,14
2278,467760,Trapper's Delight,0,False,Shrimpcave Industries,8,98,9,107
2279,467780,simian.interface++,0,False,vested interest,7,28,0,28
2280,467790,Crongdor the Barbarian,0,False,Anton Gerdelan,0,2,1,3
2281,467810,Splody,0,False,Dashing Strike,7,36,1,37
2282,467820,Zero G Arena,0,False,Jonathan Wood,8,201,23,224
2283,467850,METAGAL,0,False,RetroRevolution,5,56,27,83
2284,467090,A Game of Changes,0,False,Nuno Donato,0,5,1,6
2285,467170,Subterrarium,0,False,slimefriend,0,3,1,4
2286,467210,Evo Explores,0,False,Kyrylo Kuzyk,8,78,3,81
2287,467220,Dyna Bomb,0,False,7 Raven Studios,0,4,2,6
2288,467270,Weaves of Fate,0,False,Tom Kingston,6,30,10,40
2289,467290,Starship Titanic,0,False,The Digital Village,8,43,9,52
2290,467310,Rogue Port - Red Nightmare,0,False,Volens Nolens Games,0,1,3,4
2291,467320,God of Word,0,False,Mega Dwarf Inc.,8,52,13,65
2292,467330,Just a Cleric,0,False,DXF Games,7,21,5,26
2293,467350,Leveron Space,0,False,Hunter Games Australia,0,2,2,4
2294,467360,Off-Peak,0,True,Cosmo D,7,23,4,27
2295,467370,Escape This,0,False,Four Winged Studio,5,13,14,27
2296,467380,Khimera: Destroy All Monster Girls,0,True,Suits & Sandals,7,29,2,31
2297,467390,Approaching Blocks,0,False,Dymchick1,5,35,30,65
2298,467430,Farming 6-in-1 bundle,0,False,Aliasworlds,6,15,6,21
2299,467440,Insignificant,0,False,Significant Games,0,1,0,1
2300,466630,The Pedestrian,0,False,Skookum Arts,9,1252,31,1283
2301,466660,Stash,0,True,Frogdice,8,52,12,64
2302,466730,King's Guard TD,0,False,Freeze Nova,5,17,14,31
2303,466740,ARAYA,0,False,MAD Virtual Reality Studio,6,128,46,174
2304,466770,Ghost Croquet,0,False,ampersandbear,0,5,0,5
2305,466800,The Dope Game,0,False,CoaguCo Industries,8,117,27,144
2306,466810,Soulslayer～灭魂·误佳期～,0,False,开水工作室,7,22,1,23
2307,466820,Zenodyne R,0,False,Team Grybanser Fox,7,14,1,15
2308,466840,Super Space Pug,0,False,Digital Dawn Studios,5,50,40,90
2309,466860,上帝之城 I：监狱帝国 [City of God I - Prison Empire],0,False,Pixel Gangsta Studio,5,13,6,19
2310,466870,Aurora Nights,0,False,Vladimir Maslov,8,106,17,123
2311,466900,Hide & Spook: The Haunted Alchemist,0,True,Murray Lorden,0,2,0,2
2312,466910,Worm.is: The Game,0,True,Freakinware Studios,7,25,6,31
2313,466920,Mugen Souls Z,0,False,Idea Factory,6,24,10,34
2314,466940,The Sandbox Evolution - Craft a 2D Pixel Universe!,0,True,PIXOWL INC.,5,105,84,189
2315,466980,Can't Drive This,0,False,Pixel Maniacs,6,63,21,84
2316,467000,Insincere,0,False,Astronomic Games,5,35,34,69
2317,467010,Fall of Civilization,0,False,Luke Dodds,4,8,18,26
2318,466270,Half-Life: A Place in the West,0,True,Michael Pelletier,7,21,3,24
2319,466280,Super Cube Smash,0,False,Lewis Fitzjohn,0,2,1,3
2320,466300,Planescape: Torment: Enhanced Edition,0,False,Beamdog,8,1339,85,1424
2321,466350,Fossil Echo,0,False,Awaceb,5,25,21,46
2322,466420,Warriors' Wrath,0,False,Storm Sharks Production,5,9,7,16
2323,466430,Choice of Alexandria,0,False,Choice of Games,8,55,1,56
2324,466490,Princess Isabella: The Rise of an Heir,0,False,Gogii Games,4,11,21,32
2325,466500,35MM,0,False,Носков Сергей,5,459,342,801
2326,466520,Drone Hunter VR,0,False,Ignibit,6,14,6,20
2327,466580,GOD's DEATH,0,False,Marco Tancredi,0,1,1,2
2328,465750,Tank Battle: North Africa,0,False,HexWar Games,0,7,1,8
2329,465840,THE LAST BLADE,0,False,SNK CORPORATION,6,23,6,29
2330,465860,Awakening: The Sunhook Spire Collector's Edition,0,False,Boomzap Entertainment,0,3,1,4
2331,465870,SHOCK TROOPERS 2nd Squad,0,False,SNK CORPORATION,5,11,6,17
2332,465890,Dark Parables: The Final Cinderella Collector's Edition,0,False,Blue Tea Games,7,12,0,12
2333,465900,Dark Tales: Edgar Allan Poe's The Gold Bug Collector's Edition,0,False,AMAX Interactive,7,9,2,11
2334,465920,Echoes of the Past: The Revenge of the Witch Collector's Edition,0,False,Orneon,0,4,0,4
2335,465930,OddPlanet,0,False,Indievision,5,13,9,22
2336,465960,Farm Tribe,0,False,CrioGames,0,3,2,5
2337,465970,Grave Mania: Undead Fever,0,False,Anino Games,0,5,0,5
2338,465990,Hidden Expedition: The Crown of Solomon Collector's Edition,0,False,Eipix Entertainment,0,6,2,8
2339,466000,Maze: Subject 360 Collector's Edition,0,False,Mad Head Games,7,20,0,20
2340,466010,Nevertales: The Beauty Within Collector's Edition,0,False,Mad Head Games,0,6,0,6
2341,466020,Off the Record: The Linden Shades Collector's Edition,0,False,Eipix Entertainment,0,8,0,8
2342,466030,Otherworld: Spring of Shadows Collector's Edition,0,False,Boomzap Entertainment,0,9,0,9
2343,466040,Pet Store Panic,0,False,"Ludometrics, Ltd.",0,2,0,2
2344,466050,Redemption Cemetery: Salvation of the Lost Collector's Edition,0,False,AMAX Interactive,0,9,0,9
2345,466060,Shiver: Vanishing Hitchhiker Collector's Edition,0,False,Artogon,7,10,0,10
2346,466070,Spa Mania,0,False,Blue Lizard Games,0,1,0,1
2347,466080,Surface: The Pantheon Collector's Edition,0,False,Elephant Games,0,2,0,2
2348,466100,Witches' Legacy: The Ties That Bind Collector's Edition,0,False,EleFun Games,0,6,2,8
2349,466110,Shaolin vs Wutang,0,False,J.Bowman,8,360,26,386
2350,466130,White Day: A Labyrinth Named School,0,False,SONNORI Corp,8,136,26,162
2351,466160,Arelite Core,0,False,Dragon Slumber,7,13,0,13
2352,466210,Race & Destroy,0,False,AngryAngelGames,0,3,5,8
2353,466220,Kingdom of Loot,0,False,EPICBEYOND Studios,5,93,76,169
2354,465360,Uprising: Join or Die,0,False,Cyclone Studios,6,31,9,40
2355,465440,Aplowcalypse,0,True,Biodrone Studios,0,1,0,1
2356,465450,iOMoon,0,False,Headtrip Games llc,6,16,6,22
2357,465490,Stellar Tactics,0,False,Maverick Games,8,638,109,747
2358,465510,Sinful Eden,17,False,Dualhaze,4,6,15,21
2359,465520,PRICE,0,True,YETU GAME,7,38,3,41
2360,465540,Adventure World,0,False,Alibi,5,7,8,15
2361,465650,Out of the Park Baseball 18,0,False,Out of the Park Developments,8,371,29,400
2362,465660,Franchise Hockey Manager 3,0,False,Out of the Park Developments,5,35,28,63
2363,465670,Project G,0,False,Nebula Interactive,0,3,0,3
2364,465720,Demon Hunter 2: New Chapter,0,False,Brave Giant LTD,5,33,16,49
2365,464850,Don Bradman Cricket 17,0,False,Big Ant Studios,5,150,97,247
2366,464880,Stars in Shadow,0,False,Ashdar Games,6,361,106,467
2367,464900,Pitfall Planet,0,False,Bonfire Games,7,30,0,30
2368,464940,Sketchfab VR,0,True,Sketchfab,0,2,0,2
2369,464950,Sumer,0,False,Studio Wumpus,0,3,0,3
2370,464960,Hiiro,0,False,Jon Tiburzi,7,42,2,44
2371,465000,Event Horizon,0,False,Pavel Zinchenko,5,23,13,36
2372,465010,Quantized,0,False,Chris Mahoney,0,1,1,2
2373,465020,Sector Six,0,False,Small Moons,8,110,7,117
2374,465050,Grey Phobia,0,False,Blackturn Ltd,0,2,0,2
2375,465060,EXZEAL,0,False,TRIANGLE SERVICE,0,5,3,8
2376,465070,TRIZEAL Remix,0,False,TRIANGLE SERVICE,7,10,0,10
2377,465090,Don Bradman Cricket 17 Demo,0,True,Big Ant Studios,0,0,1,1
2378,465100,LUNA The Shadow Dust,0,False,Lantern Studio,8,184,23,207
2379,465130,Wicce,0,False,Alpheratz*,7,19,3,22
2380,465170,Crime Secrets: Crimson Lily,0,False,One More Level,5,35,23,58
2381,465180,One Day in London,0,False,Owl Studio,7,18,1,19
2382,465190,Space Survival,0,False,UltraShock Gaming LLC,0,2,5,7
2383,465200,Fury Unleashed,0,False,Awesome Games Studio,8,248,18,266
2384,465240,Serious Sam VR: The Last Hope,0,False,Croteam VR,8,631,118,749
2385,465280,Yesterday Origins,18,False,Pendulo Studios,6,80,26,106
2386,465310,Ricerca VR,0,False,"The Family, LLC",7,18,2,20
2387,464440,Annie Amber,0,False,Pantumaca Barcelona,5,15,11,26
2388,464450,DoDonPachi Resurrection,0,False,"CAVE Interactive CO.,LTD.",8,235,13,248
2389,464470,BloodGate,0,False,Outsmart,5,73,89,162
2390,464490,The Afterglow of Grisaia,0,False,Frontwing,7,31,1,32
2391,464500,The Melody of Grisaia,0,False,Frontwing,7,29,1,30
2392,464530,猫肉「Cat Meat」,0,False,2D Heroes,5,9,5,14
2393,464540,Colosse,0,True,Colosse Team,0,1,2,3
2394,464610,Led It Rain,0,False,Ataverti,0,5,0,5
2395,464620,Siralim 2,0,False,Thylacine Studios,8,353,26,379
2396,464630,Secret Of The Royal Throne,0,False,Apar Games,0,0,5,5
2397,464650,Runbow,0,False,13AM Games,7,30,6,36
2398,464670,Empty Soul - S&S Edition,0,False,ClorithStudio,6,7,3,10
2399,464690,Vroomist,0,False,Syrena Interactive,3,5,22,27
2400,464700,Maui,0,True,Kokua Games,0,2,3,5
2401,464740,Monsters and Medicine,0,False,Clockwork Acorn,0,2,0,2
2402,464780,ChuSingura46+1 S,0,True,インレ,7,17,2,19
2403,464800,Twisted Worlds,0,True,Absolutist Ltd.,0,0,1,1
2404,463980,Solitairica,0,False,Righteous Hammer Games,8,166,34,200
2405,464000,Arcade Saga,0,False,2 Bears Studio,6,25,8,33
2406,464020,Super Puzzle Galaxy,0,False,2 Bears Studio,0,2,3,5
2407,464050,Heroes Must Die,0,True,Heroic Games,0,2,1,3
2408,464060,RUINER,0,False,Reikon Games,8,3093,311,3404
2409,464070,Diorama Battle of NINJA　虚拟3D世界 忍者之战,0,False,"X-STREAM DIGITAL Co., Ltd.",0,5,2,7
2410,464080,Kyoto Colorful Days,0,False,InterOne Inc.,6,33,10,43
2411,464100,Codex of Victory,0,False,Ino-Co Plus,5,58,30,88
2412,464110,Factotum 90,0,False,TACS Games,0,5,0,5
2413,464120,Xcinerator,0,False,iolo,0,8,1,9
2414,464170,VRMark,0,False,UL,5,23,19,42
2415,464230,Colours of Magic: Aqua Teeter,0,False,RunServer,6,17,6,23
2416,464240,Detective Hunt - Crownston City PD,0,False,pixepob,5,11,6,17
2417,464260,Xeno Crisis,0,False,Bitmap Bureau,7,26,3,29
2418,464340,Syberia 3,0,False,Microids,5,291,346,637
2419,464350,Screeps: World,0,False,"Screeps, LLC",8,795,96,891
2420,464360,3030 Deathwar Redux - A Space Odyssey,0,False,Bird in Sky,9,765,39,804
2421,464380,Best of Us,0,False,Hosted Games,3,2,10,12
2422,464400,Bounce,0,False,Steel Wool Studios,7,23,1,24
2423,463670,Runeyana,0,True,Blackturn Ltd,0,5,4,9
2424,463700,Super Cloudbuilt,0,False,Coilworks,8,86,13,99
2425,463710,Puzzle Galaxies,0,False,Evermore Game Studios,4,4,10,14
2426,463800,FreeHolder,0,False,RogueWare,8,52,13,65
2427,463830,Izeriya,0,False,LigaGamesStudio,0,0,2,2
2428,463850,Muddy Heights® 2,0,False,"Rageborn Studio, LLC",6,118,33,151
2429,463860,Shadows of Kurgansk,0,False,Yadon Studio,5,25,28,53
2430,463870,Deathwave,0,False,Unknown,5,7,4,11
2431,463880,Beyond Magic,0,False,Falling Star Studio,5,10,7,17
2432,463920,Initia: Elemental Arena,0,False,Gentle Ghouls,0,1,3,4
2433,463930,The Dweller,0,False,Villainous  Games,8,179,7,186
2434,463110,Farnham Fables,0,False,Ethrea Dreams,6,91,35,126
2435,463150,BARRIER X,0,False,Noclip,6,186,48,234
2436,463160,Super Dungeon Tactics,0,False,Underbite Games,6,63,20,83
2437,463170,Jagged Alliance: Rage!,0,False,Cliffhanger Productions,5,64,48,112
2438,463180,Super Blue Fighter,0,True,Herrero Games,0,5,3,8
2439,463210,State of Anarchy,0,False,Lapovich,8,240,52,292
2440,463220,Dungeon of Zolthan,0,False,Robert Alvarez,6,112,42,154
2441,463250,One Tower,0,True,SkyReacher Entertainment,0,1,1,2
2442,463270,Ghost 1.0,0,False,@unepic_fran,8,588,80,668
2443,463290,Kismet,0,False,Psyop,8,93,7,100
2444,463320,The Sea Eternal,0,False,Choice of Games,5,10,13,23
2445,463350,Storm Of Spears RPG,0,False,Warfare Studios,6,160,66,226
2446,463390,One Thousand Lies,0,True,Keinart Lobre,7,13,2,15
2447,463400,Spellbound,0,False,Wobbly Duck Studios,7,13,3,16
2448,463430,Ironguard,0,False,Aegon Games Ltd,0,3,4,7
2449,463440,Retool,0,False,Hut 90,0,0,1,1
2450,463450,Bipolar Game,0,False,Jason Free,0,4,0,4
2451,463460,"Resette's Prescription ~Book of memory, Swaying scale~",0,False,Liz-Arts,5,9,6,15
2452,463470,Lithium: Inmate 39,0,False,Canu Arts,6,7,3,10
2453,463480,A Shooty Bit,0,False,FROG,0,4,1,5
2454,463510,Norman's Great Illusion,0,False,Civil Savages,0,4,5,9
2455,462630,RiftStar Raiders,0,False,Climax Studios,0,2,0,2
2456,462640,Surf World Series,0,False,Climax Studios,5,11,5,16
2457,462670,VR-Xterminator,0,False,Since Idea Games,0,3,0,3
2458,462680,BalanCity,0,False,MeNic Games,6,180,53,233
2459,462700,Cricket Captain 2016,0,False,Childish Things,5,24,17,41
2460,462730,Townopolis,0,False,Lonely Troops,5,19,10,29
2461,462770,Pyre,0,False,Supergiant Games,8,3900,424,4324
2462,462830,Airline Director 2 - Tycoon Game,0,False,Joona Vartiainen,4,13,30,43
2463,462860,Crawlers and Brawlers,0,False,"Ugly Beard Games, LLC",6,19,8,27
2464,462910,Poly Runner VR,0,True,"Lucid Sight, Inc.",0,3,0,3
2465,462930,AdVenture Communist,0,True,Hyper Hippo Games,5,77,41,118
2466,462940,Making History: The Second World War,0,False,Factus Games,6,83,25,108
2467,462950,The East New World,0,False,TEN10 Games,5,7,7,14
2468,462960,Caveman World: Mountains of Unga Boonga,0,False,GrabTheGames Studios,5,95,43,138
2469,462990,Tomoyo After ~It's a Wonderful Life~ English Edition,0,False,VisualArts/Key,8,199,15,214
2470,463000,Hero Battle,0,False,Wang Liwen,0,0,3,3
2471,463010,One Way Flight,0,False,SiBear Games,0,2,3,5
2472,463020,Wander No More,0,True,Zetsubou,7,11,0,11
2473,463030,Bottle,0,False,Tonguç Bodur,5,105,58,163
2474,463060,Clover Tale,0,True,FIVE-BN GAMES,0,2,1,3
2475,463070,Mecha Ritz: Steel Rondo,0,False,HEY,7,37,1,38
2476,463100,Liveza: Death of the Earth,0,False,Nikita Nefedov,0,0,5,5
2477,462220,Mahjong Deluxe 3,0,False,EnsenaSoft,7,13,3,16
2478,462240,Post Human W.A.R,0,False,Studio Chahut,6,14,5,19
2479,462250,Boiling Bolt,0,False,Persistant Studios,0,1,0,1
2480,462400,Slide Ride Arcade,0,False,ZeroBit Games,0,0,1,1
2481,462480,Sweet Escape VR,0,False,"Reailty Smash, Inc.",7,31,4,35
2482,462520,Super Kaiju,0,False,Directive Games Limited,7,12,2,14
2483,462530,8i - Make VR Human,0,True,8i,0,0,1,1
2484,462570,New Yankee in King Arthur's Court,0,False,Rionix,0,6,2,8
2485,462580,New Yankee in Santa's Service,0,False,Rionix,0,2,2,4
2486,462590,Taekwondo Grand Prix,0,False,Hello There Games,7,13,0,13
2487,462620,Pocket Kingdom,0,False,08 Games,7,34,2,36
2488,461880,Hyposphere,0,False,Atum Software,4,5,17,22
2489,461890,NORTH,0,False,Outlands,5,74,38,112
2490,461940,Plancon: Space Conflict,0,False,HeroLabs,4,4,11,15
2491,461950,Beat Cop,0,False,Pixel Crow,6,555,218,773
2492,461990,The Prison Game,0,False,MOS Games,0,0,2,2
2493,462000,Cyberpong,0,False,"COLOPL, Inc.",8,72,10,82
2494,462070,IWO: Bloodbath in the Bonins,0,False,Guerilla Tea Games,0,3,5,8
2495,462100,Starr Mazer: DSP,0,False,Imagos Softworks,8,136,30,166
2496,462110,3 Coins At School,0,False,89AM Studio,4,4,7,11
2497,462130,Momentum,0,False,Projectile Entertainment,0,5,0,5
2498,461390,Bulby - Diamond Course,0,False,Rafael Senne,4,3,7,10
2499,461400,Massive,0,False,Rootify,5,8,12,20
2500,461410,Protonwar,0,True,Outer Planet Studios,7,43,6,49
2501,461430,EmergeNYC,0,False,FlipSwitch Games,5,1476,729,2205
2502,461480,Archibald's Adventures,0,False,Rake in Grass,7,18,1,19
2503,461490,Kaboom Monsters,0,False,Broken Arms Games,5,20,20,40
2504,461510,Tears of Avia,0,False,CooCooSqueaky Games,5,13,8,21
2505,461520,Grizzly Valley,0,False,The_Kiddy,4,12,40,52
2506,461560,MANDAGON,0,True,Blind Sky Studios,8,99,6,105
2507,461580,Galaxy Cannon Rider,0,False,Coolegion Studios,0,1,1,2
2508,461590,The Way Of Love: Sub Zero,0,False,RSK Entertainment,0,3,2,5
2509,461600,Zipple World 2: The Sweet Chaos,0,False,Alternative Dreams Studios,0,1,1,2
2510,461640,Sins Of The Demon RPG,0,False,Chandler Rounsley,8,344,57,401
2511,461650,It's Killing Time,0,False,Choice of Games,5,10,5,15
2512,461680,FPV Air Tracks,0,True,Flyleap Studios,4,12,28,40
2513,461700,Seduce Me 2: The Demon War,0,False,Michaela Laws,8,262,16,278
2514,461710,Tales Across Time,0,False,Critical Games,7,19,3,22
2515,461750,Ghoul Kid,0,True,Specter Game Studios,0,1,0,1
2516,461760,Reptilian Rebellion,0,False,Herrero Games,0,4,5,9
2517,461780,Moonstone Tavern - A Fantasy Tavern Sim!,0,False,Trevor Jones,4,21,52,73
2518,461810,CAFE 0 ~The Sleeping Beast~,0,False,ROSEVERTE MYSTERY,7,23,3,26
2519,461820,Legionwood 1: Tale of the Two Swords,0,True,Dark Gaia Studios,0,1,1,2
2520,461830,Adventure Apes and the Mayan Mystery,0,False,ScaryPotato,0,2,0,2
2521,461840,Zenge,0,False,Michal Pawlowski,8,793,59,852
2522,461850,Abrix 2 - Diamond version,0,False,EJRGames,0,3,1,4
2523,461860,Tower Dwellers,0,False,ECC GAMES SP. Z O.O.,5,6,5,11
2524,461010,Roll'd,0,False,MGP Studios,6,51,14,65
2525,461030,A Long Way Home,0,False,Jonathan Mulcahy,6,10,4,14
2526,461170,Bucket Detective,0,False,the whale husband,8,146,19,165
2527,461180,SurrealVR,0,True,Surreal Games,0,2,0,2
2528,461210,Riding Out,0,False,UnexEvo,5,24,23,47
2529,461220,Beglitched,0,False,Hexecutable,8,71,8,79
2530,461230,Dashy Square,0,False,Kastriot Sulejmani,8,54,11,65
2531,461280,Missileman Origins,0,False,Ryan Silberman,0,3,0,3
2532,461320,Smackitball,0,True,Kevin Fathi,0,2,1,3
2533,461340,A Timely Intervention,0,False,Aldorlea Games,7,17,2,19
2534,461350,The King's Heroes,0,False,Aldorlea Games,6,7,3,10
2535,461360,Thorne - Son of Slaves (Ep.2),0,False,Thorne Games,7,14,3,17
2536,461370,Midnight's Blessing 2,0,False,Warfare Studios,0,2,2,4
2537,461380,A Princess' Tale,0,False,Warfare Studios,5,11,11,22
2538,460560,Blamdown: Udder Fury,0,False,Guru Games,0,8,0,8
2539,460580,Star Chart,0,False,Escapist Games Ltd,5,6,6,12
2540,460630,Trouble Witches Origin - Episode1 Daughters of Amalgam -,0,False,Studio SiestA,7,42,2,44
2541,460640,Breached,0,False,Drama Drifters,5,22,22,44
2542,460650,Tick Tock Bang Bang,0,False,"Dejobaan Games, LLC",5,17,10,27
2543,460700,Song of the Deep,0,False,Insomniac Games,8,239,51,290
2544,460730,Draco Dux,0,False,Szymon Sikora,0,1,0,1
2545,460750,Blade Ballet,0,False,DreamSail Games,7,19,4,23
2546,460780,Avadon 3: The Warborn,0,False,Spiderweb Software,8,66,5,71
2547,460790,Bayonetta,17,False,PlatinumGames,8,4996,493,5489
2548,460810,Vanquish,18,False,PlatinumGames,8,2227,256,2483
2549,460850,Allumette,0,True,Penrose Studios,0,8,0,8
2550,460910,A-Gents,0,False,phime studio LLC,6,11,3,14
2551,460920,Steep™,0,False,Ubisoft Annecy,8,5431,1175,6606
2552,460930,Tom Clancy's Ghost Recon® Wildlands,0,False,Ubisoft Paris,6,14076,3616,17692
2553,460940,Father´s Island,0,False,Homegrown Games,5,13,9,22
2554,460960,The Deed: Dynasty,0,False,Pilgrim Adventures,8,132,9,141
2555,460970,Soulcaster: Part I & II,0,False,MagicalTimeBean,7,13,3,16
2556,460990,The Impossible Travel Agency,0,False,Holospark,5,16,9,25
2557,460060,Varenje,0,True,Play Cute,6,21,8,29
2558,460120,Megadimension Neptunia VII,0,False,Idea Factory,8,1271,84,1355
2559,460140,Midnight at the Celestial Palace: Part I,0,False,Orrery Games,7,19,1,20
2560,460150,One Last Chance,0,False,Last Lotus,5,16,9,25
2561,460160,The Leisure of Grisaia,0,False,Frontwing,8,137,14,151
2562,460190,Rocket Riot,0,False,Codeglue,0,8,0,8
2563,460210,Bearslayer,0,False,bool games;,0,4,0,4
2564,460220,Xenoraid: The First Space War,0,False,10tons Ltd,8,53,4,57
2565,460230,Starters Orders 6 Horse Racing,0,False,Strategic Designs Ltd.,6,52,18,70
2566,460250,🔴 Circles,0,False,Jeroen Wimmers,7,24,2,26
2567,460340,Guards,0,False,Battlecruiser Games,6,64,20,84
2568,460430,The Letter - Horror Visual Novel,0,False,Yangyang Mobile,8,602,60,662
2569,460470,Hindenburg VR,0,False,Michal Bárta,7,10,2,12
2570,460510,One Dark Night,0,True,Emblematic Group,0,1,1,2
2571,460540,Temple of Rust,0,True,James Mearman,0,1,0,1
2572,459610,Star Fleet Armada Rogue Adventures,0,False,Blue  Blaze Gaming,7,17,4,21
2573,459630,R.C. Bot Inc.,0,False,Blue Budgie Studios,0,1,5,6
2574,459640,You... and who else?,0,False,Aldorlea Games,5,9,4,13
2575,459680,Auro: A Monster-Bumping Adventure,0,False,Dinofarm Games,6,31,9,40
2576,459730,A World With No Colour,0,False,Poisson Rouge Interactica,0,2,0,2
2577,459760,Exotic Matter,0,False,Moebiusgames,0,4,3,7
2578,459780,Vektron Revenge,0,False,Ludovic Texier,0,4,0,4
2579,459830,Final Days,0,False,+7 Software,7,25,6,31
2580,459870,VIRTUAnimator,0,False,Pheonise,0,3,2,5
2581,459880,PlayFortress,0,False,PlayFortress,5,6,5,11
2582,459940,Deer Man,0,False,Red Mount Media,5,112,52,164
2583,459130,Love in the Glen,0,False,Sapphire Dragon Productions,5,14,7,21
2584,459150,Super Cat Herding: Totally Awesome Edition,0,False,ZoopTEK,7,13,1,14
2585,459160,Allods Online,0,True,IT Territory,0,3,1,4
2586,459170,Discovr™ Egypt: King Tut's Tomb,0,True,Discovr Labs,0,2,6,8
2587,459220,Halo Wars: Definitive Edition,0,False,Ensemble Studios,8,2928,290,3218
2588,459260,Bowslinger,0,False,Pompaduo,5,12,12,24
2589,459310,The Hero Project: Redemption Season,0,False,Choice of Games,5,64,39,103
2590,459350,Battlesloths 2025: The Great Pizza Wars,0,False,Invisible Collective,7,32,5,37
2591,459370,Riverbond,0,False,Cococucumber,7,19,4,23
2592,459410,Sector 724,0,False,Fedor Votrin,0,2,3,5
2593,459470,Wars of Napoleon,0,False,Ageod,5,18,19,37
2594,459520,Kinacoustic,0,False,Maithonis Studios,7,9,1,10
2595,459540,Cherry Tree High Girls' Fight,0,False,773,6,31,11,42
2596,459550,Catch Canvas,0,False,Unwonted Studios,6,48,18,66
2597,459580,LightWalk,0,False,Timeless Games,0,9,0,9
2598,458660,The Slimeking's Tower,0,True,CodeManu,6,9,3,12
2599,458680,Auto Age: Standoff,0,False,Phantom Compass,7,28,3,31
2600,458700,Cursor Challenge,0,False,Insane Dreamers,6,8,3,11
2601,458730,Conception II: Children of the Seven Stars,0,False,"Spike Chunsoft Co., Ltd.",8,295,58,353
2602,458750,FireAlpaca SE,0,False,PGN Inc,7,41,4,45
2603,458760,Palinurus,0,True,Watercress Studios,7,12,0,12
2604,458770,WRC 6 FIA World Rally Championship,0,False,KT Racing,5,87,64,151
2605,458820,"States, Firms, & Households",0,False,DMD 'Ware,0,0,2,2
2606,458830,Snooker Nation Championship,0,False,Cherry Pop Games,5,84,62,146
2607,458920,Carnival Games® VR,0,False,Cat Daddy Games,5,84,75,159
2608,458960,Winning Putt: Golf Online,0,False,"WEBZENONNET Co., Ltd.",5,9,8,17
2609,458990,Astral Domine,0,False,Spectral Illusions,5,9,10,19
2610,459010,Ghost Town Mine Ride & Shootin' Gallery,0,False,Spectral Illusions,8,276,43,319
2611,459020,Melting Hearts: Our Love Will Grow 2,0,False,John Wizard,5,18,15,33
2612,459040,Medieval Battlefields - Black Edition,0,False,Cateia Games,0,3,3,6
2613,459080,YIIK: A Postmodern RPG,0,False,Ackk Studios,5,81,73,154
2614,459090,Masquerada: Songs and Shadows,0,False,Witching Hour Studios,8,188,18,206
2615,458200,Rumpus,0,False,Luke Iannini,0,1,1,2
2616,458230,Infinite Shooter,0,False,Minion Productions Inc.,0,1,1,2
2617,458290,Space Bit Attack,0,False,"Lucid Sight, Inc.",0,5,3,8
2618,458330,Vilmonic,0,False,Bludgeonsoft,6,35,9,44
2619,458360,eMedia Piano and Keyboard Method,0,False,eMedia Music,7,19,0,19
2620,458370,VR Baseball,0,False,Rank17,5,10,6,16
2621,458380,Gahkthun of the Golden Lightning Steam Edition,18,False,Liar-soft,7,32,5,37
2622,458420,Last Heroes 3,0,False,Warfare Studios,5,11,8,19
2623,458450,GAIN,0,False,Worldgame entertainement,0,1,3,4
2624,458470,Grim Legends 3: The Dark City,0,False,Artifex Mundi,8,162,9,171
2625,458480,Mythic Wonders: The Philosopher's Stone,0,False,Organic 2 Digital Studio,8,72,7,79
2626,458490,Who Must Die,0,False,White Chamber,5,8,6,14
2627,458500,Babylon 2055 Pinball,0,False,Shine Research,0,0,1,1
2628,458510,Zombie Pinball,0,False,Shine Research,5,7,5,12
2629,458520,Wrath of Anna,0,False,Lorenzo Ent.,6,22,7,29
2630,458540,Lines,0,False,Gamious,7,16,2,18
2631,458560,Plastic Playground,0,True,Tomorrow Arts,0,0,1,1
2632,458580,Windlands 2,0,False,Psytec Games Ltd,8,200,48,248
2633,458590,ABE VR,0,True,Hammerhead VR,0,1,0,1
2634,458600,ZRoll,0,False,KxONE,4,9,16,25
2635,458630,Political Animals,0,False,Squeaky Wheel,5,50,31,81
2636,457710,Road Madness,0,False,Faton,4,31,103,134
2637,457730,Mushroom Wars 2,0,False,Zillion Whales,5,120,85,205
2638,457760,The Signal From Tölva,0,False,Big Robot Ltd,6,403,160,563
2639,457770,Audio Arena,0,False,Skydome Studios,7,12,1,13
2640,457810,Sky to Fly: Soulless Leviathan,0,False,AIVIK LLC,5,5,6,11
2641,457820,Outrage,0,False,Astronomic Games,5,14,15,29
2642,457860,Apollo 11 VR,0,False,Immersive VR Education Ltd.,8,357,65,422
2643,457870,Minigame Party VR,0,False,Scornz,0,2,2,4
2644,457890,TumbleSeed,0,False,Benedict Fritz,8,58,6,64
2645,457960,Holopoint,0,False,"Alzan Studios, LLC",8,510,60,570
2646,457980,Adele: Following the Signs,0,False,Unosquare,0,2,5,7
2647,458000,March of the Living,0,False,Machine 22,6,248,96,344
2648,458030,StarFringe: Adversus,0,False,Casualogic,0,4,2,6
2649,458040,Hex Gambit,0,False,One Man Left Studios,7,8,2,10
2650,458060,Drusilla Dreams,0,False,Seraphim Creations,4,5,17,22
2651,458110,VReakout,0,False,Animate Objects,0,1,1,2
2652,458170,SpiritSphere DX,0,False,Eendhoorn Games,7,13,0,13
2653,458180,POSTZ: ZOMBIES VR,0,False,Sea Lion Games,0,2,0,2
2654,457210,SEUM: Speedrunners from Hell,0,False,Pine Studio,9,917,37,954
2655,457230,Atlas Reactor VR Character Viewer,0,False,Trion Worlds,0,1,0,1
2656,457320,HoloBall,0,False,TreeFortress Games,8,326,32,358
2657,457340,Dimensional,0,False,Brett Jackson,6,33,9,42
2658,457370,Alexa's Wild Night,0,False,Dharker Studio,7,15,2,17
2659,457380,Storm VR,0,True,TeamStormVR,5,35,17,52
2660,457420,Surgeon Simulator VR: Meet The Medic,0,True,Bossa Studios,0,1,0,1
2661,457450,Defend Your Crypt,0,False,Ratalaika Games S.L.,5,5,6,11
2662,457480,Domino Sky,0,False,Russpuppy,6,98,27,125
2663,457490,"Forgotten, Not Lost - A Kinetic Novel",0,False,Afterthought Studios,8,51,10,61
2664,457520,Moustache Mountain,0,False,Nauris Amatnieks,6,39,16,55
2665,457530,My Lady,0,False,Michaela Laws,8,85,20,105
2666,457570,Camp Sunshine,0,False,Fossil Games,8,114,17,131
2667,457600,Emerge: Cities of the Apocalypse,0,False,Emilios Manolidis,5,69,36,105
2668,457650,Stonehenge VR SANDBOX,0,False,VoyagerVR,0,1,1,2
2669,457660,Andromedum,0,False,Imbanova Entertainment Inc.,5,11,5,16
2670,457680,OPUS: The Day We Found Earth,0,False,SIGONO INC.,6,178,54,232
2671,457690,Hotel Blind,0,False,Serellan LLC,5,5,6,11
2672,456920,Gary the Gull,0,True,Motional Entertainment,0,1,0,1
2673,457010,StarsOne,0,False,IllusoryWorldEntertainment,6,103,39,142
2674,457130,Runes: The Forgotten Path,0,True,StormBorn Studio,7,30,6,36
2675,456390,Exception,0,False,Traxmaster Software,0,7,0,7
2676,456420,Gunslinger Trainer,0,False,Marcus Nichols,0,0,6,6
2677,456430,Christmas Adventure: Candy Storm,0,False,Argali Entertainment,8,150,18,168
2678,456440,The Orphan Dreams,0,False,Tayfun Tuna,0,2,1,3
2679,456450,Jaunt VR - Experience Cinematic Virtual Reality,0,True,Jaunt Inc.,0,0,3,3
2680,456540,STAR WARS™: Rebel Assault I + II,0,False,LucasArts,6,76,28,104
2681,456660,Slime & Friends,0,False,Heartomics,0,4,3,7
2682,456670,Hand of Fate 2,0,False,Defiant Development,8,1375,246,1621
2683,456690,Weather Lord: Following the Princess Collector's Edition,0,False,Yustas Game Studio,0,1,0,1
2684,456740,Doctor Kvorak's Obliteration Game,0,False,Freekstorm,0,4,0,4
2685,456750,The Room Three,0,False,Fireproof Games,9,3177,122,3299
2686,456760,A dragon girl looks up at the endless sky,0,False,DebonosuWorks Inc.,7,14,3,17
2687,456780,DUCATI - 90th Anniversary,0,False,Milestone S.r.l.,5,27,12,39
2688,456810,Zombillie,0,False,Forever Entertainment S. A.,5,24,13,37
2689,456830,Dual Core,0,False,Gray Fin Studios,7,12,1,13
2690,455940,Odd||Even,0,False,irritatingFLY studio,4,7,12,19
2691,455960,Domain Defense,0,False,Inclusion Studios,5,10,12,22
2692,455970,Nokori,0,False,Heartomics,0,3,5,8
2693,455980,Judgment: Apocalypse Survival Simulation,0,False,Suncrash,8,740,167,907
2694,455990,Smash Pixel Racing,0,False,Jollyfish Games,0,2,0,2
2695,456090,Dead Some Day,0,False,Bitporters LTD.,0,2,7,9
2696,456130,Space Scaven,0,False,Moon Pub Games,0,4,1,5
2697,456150,SpaceSys,0,False,3DEA,0,0,2,2
2698,456160,Flag N Frag,0,False,EDEVOX,0,2,2,4
2699,456170,Bannerman,0,False,Armitage Games,6,58,16,74
2700,456180,The American Dream,0,False,Samurai Punk,5,46,29,75
2701,456210,A Land Fit For Heroes,0,False,Liber Primus Games,0,3,2,5
2702,455590,Skedaddle,0,False,plaiko,0,5,1,6
2703,455640,Edgar,0,False,Lucas Parise,0,2,1,3
2704,455700,Big Buck Hunter Arcade,0,False,GameMill Entertainment,5,18,10,28
2705,455710,Project RPG Remastered,0,False,Acuze Interactives,5,11,8,19
2706,455720,Dolphin Defense,0,False,Unknown,0,3,2,5
2707,455770,YamaYama,0,False,Lumenox ehf,0,6,2,8
2708,455820,Omensight: Definitive Edition,0,False,Spearhead Games,8,481,61,542
2709,455830,FrightShow Fighter,0,False,3 Fright,0,6,2,8
2710,455910,STAR WARS™: Rogue Squadron 3D,0,False,Factor 5,6,492,200,692
2711,455120,Stay Close,0,False,Blind Bird,5,277,211,488
2712,455190,Domain Defense VR,0,False,Inclusion Studios,7,8,2,10
2713,455200,The Battle for Sector 219,0,False,Large Visible Machine,5,5,7,12
2714,455230,Bazaar,0,False,Temple Gates Games,0,8,1,9
2715,455290,Dashing Dinos,0,False,Lost Mountain,0,2,0,2
2716,455310,Bloody Chronicles - New Cycle of Death Visual Novel,0,False,Igrasil Development Team,5,16,7,23
2717,455340,"Warhammer 40,000: Armageddon - Da Orks",0,False,Flashback Games,5,22,14,36
2718,455400,PAC-MAN 256,0,False,BANDAI NAMCO Studios Vancouver,8,450,24,474
2719,455440,Spell Fighter VR,0,True,Kubold,0,6,3,9
2720,455480,Shift Orb,0,False,Afterlife Games,0,0,1,1
2721,455490,"Don't Die Dateless, Dummy!",0,False,cupholder,5,31,16,47
2722,454670,Piggy Princess,0,False,DreamsSoftGames,0,2,0,2
2723,454680,MetaTron,0,False,TubbyKiD UG (haftungsbeschränkt),4,4,7,11
2724,454690,Cyber City 2157: The Visual Novel,0,False,Harotobira,0,6,2,8
2725,454700,Shiny Gauntlet,0,False,Spritewrench,0,0,2,2
2726,454720,RAM BOE,0,False,pointfiveteam,0,4,5,9
2727,454730,World Of Undead,0,False,ZK-Tech,0,0,4,4
2728,454750,Aeternum,0,False,Creaky Lantern Games,0,4,0,4
2729,454770,Mystic Melee,0,False,Ben Hopkins,7,13,3,16
2730,454780,Atriage,0,False,Batu Games LLC,0,2,0,2
2731,454830,Beach Ball Valley,0,False,Paul Eckhardt,0,5,0,5
2732,454870,Magic Quest,0,False,Stereo7 Games,0,5,2,7
2733,454890,Project Starship,0,False,Panda Indie Studio,6,94,24,118
2734,454900,Amaranthine,0,False,Roman Kozhukhov,7,34,4,38
2735,454950,Mainlining,0,False,Rebelephant,6,147,37,184
2736,454970,Gravity Den,0,False,DiPi Games,0,3,1,4
2737,455000,The Lost,10,False,Duang,0,0,1,1
2738,455080,Awakening: The Redleaf Forest Collector's Edition,0,False,Boomzap Entertainment,0,8,1,9
2739,455100,Gerty,0,False,Spawn Point OSK,7,16,2,18
2740,455110,Pertinence,0,False,Not Magic,5,6,5,11
2741,454170,XorceD - Sashiro's Laedrum,0,False,Xorcerox,0,5,0,5
2742,454180,CrazyCars3D,0,False,AneaGames,5,44,21,65
2743,454190,Cubicolor,0,False,Moltenplay,8,61,6,67
2744,454200,Neon Hardcorps,0,False,Sergey Dovganovskiy,4,8,15,23
2745,454220,The Temporal Invasion,0,False,Hybriona Labs,6,43,18,61
2746,454230,SLG Remix,0,False,1812 Productions (PC Port),4,4,9,13
2747,454240,A Tofu Tail,0,False,alchemedium,0,3,0,3
2748,454250,The Eyes of Ara,0,False,100 Stones Interactive,8,232,45,277
2749,454260,The HinterLands,0,False,Ackmi,0,2,2,4
2750,454320,[the Sequence],0,False,[OneManBand],8,77,9,86
2751,454330,A Room Beyond,0,False,René Bühling,0,6,2,8
2752,454350,Days of War: Definitive Edition,0,False,Driven Arts,5,337,380,717
2753,454370,Battlecursed,0,False,Codex Worlds,0,3,3,6
2754,454390,Rally Copters,0,False,Depth First Games,0,3,0,3
2755,454410,GIGA WRECKER,0,False,GAME FREAK inc.,6,99,25,124
2756,454420,Mini Metal,0,False,Luandun Games Pte. Ltd.,0,1,0,1
2757,454430,Crystal Chip Collector,0,False,Nekomura Games,0,0,1,1
2758,454480,Break Through: Artificial Maze,0,False,SUN MONKEY Games,0,0,1,1
2759,454520,MilitAnt,0,False,Xibalba Studios,0,2,3,5
2760,454530,Decisive Campaigns: Barbarossa,0,False,VR Designs,8,78,9,87
2761,454540,LuckCatchers,0,True,DiP Online,0,0,5,5
2762,454550,Qubicle Voxel Editor,0,False,Minddesk Software GmbH,5,42,22,64
2763,454560,Ultimate Fight Manager 2016,0,False,Snowfall,4,7,11,18
2764,454570,I Am Caligula,0,False,Seraphim Creations,5,14,9,23
2765,454580,Spider Wars,0,False,CarVin Interactive,5,10,5,15
2766,454600,Age of Cavemen,0,True,Fuero Games,0,1,3,4
2767,454610,Demon's Crystals,0,False,Byte4Games,5,14,9,23
2768,454630,Button Frenzy,0,False,zerofiftyone,0,6,1,7
2769,454650,DRAGON BALL XENOVERSE 2,0,False,QLOC,8,8133,1406,9539
2770,453660,Rogue Contracts: Syndicate,0,False,Go Dark Studios,0,6,3,9
2771,453670,The Lost Souls,0,False,GDNomad,3,5,28,33
2772,453690,Dark Quest 2,0,False,Brain Seal Ltd,6,198,51,249
2773,453700,prog.1,0,False,Vector Arcade,0,6,2,8
2774,453710,TableTop Soccer,0,False,Dancing Developers,7,39,9,48
2775,453720,Last Will,0,False,LizardFactory,6,69,27,96
2776,453730,Borstal,0,False,The Secret Pie,4,3,7,10
2777,453740,Spaceman Sparkles 3,0,False,tjern,7,10,2,12
2778,453750,Tyto Ecology,0,False,Immersed Games,6,252,76,328
2779,453770,Forgotten Tales: Day of the Dead,0,False,Green Sauce Games,5,8,4,12
2780,453780,Secrets of Magic: The Book of Spells,0,False,Green Sauce Games,7,13,0,13
2781,453790,Candice DeBébé's Incredibly Trick Lifestyle,0,False,Havishamone Games,8,95,7,102
2782,453810,Blasting Agent: Ultimate Edition,0,False,"Axol Studio, LLC",5,9,7,16
2783,453820,Hero Quest: Tower Conflict,0,False,Mihai Morosanu,3,7,40,47
2784,453830,Innoquous 5,0,False,Chequered Ink Ltd.,0,6,0,6
2785,453850,Dear RED - Extended,0,False,Lee Sang,5,24,27,51
2786,453870,Quantum Chess,0,False,Quantum Realm Games,5,19,10,29
2787,453880,Ninja Outbreak,0,False,Renegade Sector Games,0,2,1,3
2788,453890,Black Rose,0,True,Sir Bedlam Productions,7,10,2,12
2789,453910,Love is Dead,0,False,Curiobot,7,17,4,21
2790,453950,To Ash,0,False,16 Bit Psych,7,10,2,12
2791,453960,Envy the Dead,0,False,Kazakov Oleg,5,34,22,56
2792,453980,Airstrike HD,0,False,Fifth Dimension Company,0,1,5,6
2793,453990,Mibibli's Quest,0,False,Resni,7,41,2,43
2794,454030,Link,0,False,Brainwashing Games,5,17,10,27
2795,454060,Blueprint Tycoon,0,False,Endless Loop Studios,8,528,131,659
2796,454070,Boundel: The Second Era,0,True,Eren Aydin,5,82,61,143
2797,454080,Burst,0,False,David Mulder,5,5,6,11
2798,454100,Dungeon Escape,0,False,Roenko Games,5,89,39,128
2799,454130,Nil-Ninjahtic: Ronin,0,False,Blaze Epic,5,9,4,13
2800,454140,First Person Tennis - The Real Tennis Simulator VR,0,False,Mikori Games,8,148,17,165
2801,454160,Dark Fear,0,False,Arif Games,8,75,3,78
2802,453220,BrambleLash,0,False,Bytesprite,0,5,2,7
2803,453270,Madness Cubed,0,False,epic dreams,5,43,25,68
2804,453290,Awareness Rooms,0,False,GAME NA KIBUN,8,152,37,189
2805,453300,A Healer Only Lives Twice,0,False,Pon Pon Games,6,59,18,77
2806,453310,Blackwood Crossing,0,False,PaperSeven LTD,6,133,35,168
2807,453320,Vairon's Wrath,0,False,Myoubouh Corp,0,1,0,1
2808,453340,Hustle Cat,0,False,Date Nighto,9,717,34,751
2809,453350,Vaccine War,0,False,Games For Tutti,0,2,6,8
2810,453390,Dark Parables: The Little Mermaid and the Purple Tide Collector's Edition,0,False,Blue Tea Games,7,24,3,27
2811,453500,Frio - Lost in old town,0,False,erocona,7,15,2,17
2812,453510,One Man Is Not No Man,0,True,TEN TIULENYA team,0,5,0,5
2813,453650,Marble Void,0,False,Leveled Games,7,14,2,16
2814,452710,Realities,0,True,realities.io,0,1,0,1
2815,452860,Mad Bullets,0,False,isTom Games Kft.,8,100,8,108
2816,452920,Laser Disco Defenders,0,False,Out Of Bounds,0,2,0,2
2817,452930,Insane,0,False,VIS-Games,0,1,1,2
2818,452940,Theory Test UK 2016/17 - Driving Test Success,0,False,Imagitech,7,32,0,32
2819,452950,Hazard Perception Test UK 2016/17 Bundle - Driving Test Success,0,False,Imagitech,0,4,5,9
2820,452970,Asemblance,0,False,Nilo Studios,5,49,29,78
2821,453030,The Fifth Expedition,0,False,Snapjaw Games GmbH,0,3,2,5
2822,453100,Frederic: Resurrection of Music Director's Cut,0,False,Forever Entertainment S. A.,8,62,11,73
2823,453130,Powargrid,0,False,Wee Free Studio,6,7,3,10
2824,452320,Party Saboteurs: After Party,0,False,The Glitch Factory,6,9,3,12
2825,452340,Ian's Eyes,0,True,Sindie Games,5,8,12,20
2826,452410,Damsel,0,False,Screwtape Studios,6,19,5,24
2827,452420,Koihime Enbu 恋姫†演武,0,False,UNKNOWN GAMES,8,74,18,92
2828,452450,Rising Islands,0,False,Lone Hero Studios,5,11,14,25
2829,452490,The Cubicle.,0,True,Roel van Beek,0,6,3,9
2830,452510,UNDER NIGHT IN-BIRTH Exe:Late,0,False,FRENCH-BREAD,8,362,26,388
2831,452570,Battle Chef Brigade Deluxe,0,False,Trinket Studios,9,593,14,607
2832,452650,The Rebel,0,False,Clockwork Game Software,0,2,4,6
2833,451780,Trillion: God of Destruction,0,False,IDEA FACTORY,6,149,62,211
2834,451800,End Of The Mine,0,False,Skirmish Entertainment,0,5,3,8
2835,451840,Out of Ammo,0,False,RocketWerkz,8,476,93,569
2836,451870,Nighttime Terror VR: Dessert Defender,0,False,Mark Schramm,0,6,3,9
2837,451880,Catch a Falling Star,0,False,Alister Software,6,79,26,105
2838,451900,WizardCraft,0,False,David Mccue,5,12,7,19
2839,451920,Thorne - Death Merchants,0,False,Thorne Games,5,44,22,66
2840,451930,qrth-phyl,0,False,Verran,7,12,1,13
2841,451940,Return Home,0,False,Verran,0,2,0,2
2842,451950,EEP Train Simulator Mission,0,False,Trend Redaktions- und Verlagsgesellschaft mbH,0,1,7,8
2843,451960,The Secret of Pineview Forest,0,True,VIS-Games,0,1,1,2
2844,451980,The Body VR: Journey Inside a Cell,0,True,The Body VR LLC,0,9,0,9
2845,451990,Cranks and Goggles,0,False,Play Native Entertainment,6,73,21,94
2846,452000,Military Life: Tank Simulator,0,False,United Independent Entertainment GmbH,5,6,7,13
2847,452060,Caveblazers,0,False,Deadpan Games,8,1007,147,1154
2848,452120,Midvinter,0,False,Talecore Studios,7,18,4,22
2849,452230,Spellstone,0,True,Synapse Games,0,2,0,2
2850,452240,Dawn of the Robot Empire,0,False,"oeFun, Inc.",0,7,0,7
2851,451520,theBlu,0,False,"Wevr, Inc.",8,697,122,819
2852,451540,Snakes on an Extradimensional Plane,0,False,Team Neon Snakes,0,2,0,2
2853,451570,Demetrios - The BIG Cynical Adventure,0,False,COWCAT,6,62,19,81
2854,451600,CounterAttack,0,False,Relative Games,8,108,8,116
2855,451630,Brute,0,False,MGFM,7,12,1,13
2856,451640,C14 Dating,0,False,Winter Wolves,7,36,4,40
2857,451650,Whirligig VR Media Player,0,False,Philip Day,6,237,62,299
2858,451660,Trucker,0,False,Play Publishing,5,10,10,20
2859,451670,War Birds: WW2 Air strike 1942,0,False,HGames-ArtWorks,3,2,16,18
2860,451700,Secrets of Deep Earth Shrine,0,False,Chronicle Games,0,1,0,1
2861,451760,Highway Blossoms,0,False,Studio Élan,9,778,29,807
2862,451060,Wincars Racer,0,False,DragonJam Studios,0,0,2,2
2863,451080,Giant Cop: Justice Above All,0,False,Other Ocean Interactive,5,17,8,25
2864,451100,Cubikolor,0,False,Fractal Box,0,4,0,4
2865,451130,Khan: Absolute Power,0,True,Mirinae,0,1,1,2
2866,451140,Drawn®: Dark Flight™ Collector's Edition,0,False,Big Fish Studios,6,15,5,20
2867,451200,Candlelight,0,False,Pixel Maverick Games,0,8,0,8
2868,451210,Rocket Shooter,0,False,VLLADGET,0,1,2,3
2869,451340,Gold Rush: The Game,0,False,Code Horizon,5,3316,1535,4851
2870,451350,Tropical Fish Shop 2,0,False,Rainbow Games,0,3,3,6
2871,451400,Meridian: Squad 22,0,False,Elder Games,5,18,17,35
2872,451450,Hollywood Hills Mansion,0,False,"LOOT Interactive, LLC",0,5,2,7
2873,450590,Safety Driving Simulator: Car,0,False,United Independent Entertainment GmbH,4,11,18,29
2874,450600,Safety Driving Simulator: Motorbike,0,False,United Independent Entertainment GmbH,5,8,11,19
2875,450630,Woeful Woebots,0,False,Hello Bard AS,0,7,2,9
2876,450650,Polyology,0,False,Gridlock Interactive,0,7,0,7
2877,450670,Table Top Racing: World Tour,0,False,Playrise Digital Ltd.,6,96,31,127
2878,450700,The Spatials: Galactology,0,False,Weird and Wry,6,92,36,128
2879,450740,Mind Unleashed,0,False,Frost Earth Studio,5,7,10,17
2880,450760,GraveRun,0,False,W@ Games,0,7,0,7
2881,450950,Danmaku Unlimited 3,0,False,Doragon Entertainment,8,83,6,89
2882,451000,Ember Kaboom,0,False,Josh Koenig (Slashandz),0,8,1,9
2883,451010,Kittypocalypse,0,False,Bolverk Games,8,122,20,142
2884,451020,Battle Chasers: Nightwar,0,False,Airship Syndicate,8,1699,252,1951
2885,450110,Amigdala,0,False,GuidiGermano,7,10,2,12
2886,450120,Capitalism Plus,0,False,Enlight Software Limited,7,40,8,48
2887,450140,Seven Kingdoms: Ancient Adversaries,0,False,Enlight Software Limited,8,62,1,63
2888,450150,Campgrounds: The Endorus Expedition Collector's Edition,0,False,Jumb-O-Fun,0,1,0,1
2889,450170,BOOR,0,False,DazlogStudio,6,54,19,73
2890,450190,MAZE LORD,0,False,Jetdogs Studios,5,31,14,45
2891,450220,Overload Playable Teaser 3.0,0,True,"Revival Productions, LLC",7,19,1,20
2892,450250,Aegis of Earth: Protonovus Assault,0,False,Acquire,7,16,4,20
2893,450290,Assault on Arnhem,0,False,Bookmark Games,4,6,10,16
2894,450390,The Lab,0,True,Valve,8,112,3,115
2895,450440,Creepy Castle,0,False,Dopterra,8,99,14,113
2896,450500,Ace of Seafood,0,False,Calappa Games,8,219,17,236
2897,450540,"Hot Dogs, Horseshoes & Hand Grenades",0,False,RUST LTD.,9,9995,307,10302
2898,449680,SAMOLIOTIK,0,False,Unknown,8,144,36,180
2899,449690,Fatal Fight,0,False,Fighting Games,5,11,9,20
2900,449700,Ariel,0,False,Nuclear Fiction,0,5,1,6
2901,449710,REDCON,0,False,Hexage,6,181,61,242
2902,449730,Ahnayro: The Dream World,0,False,Alice & Smith,8,103,13,116
2903,449760,Tenrow,0,False,Cleverweek,5,20,9,29
2904,449770,Legend of Moros,0,False,Cannibal Interactive,0,1,0,1
2905,449800,Attack on Titan / A.O.T. Wings of Freedom,18,False,"KOEI TECMO GAMES CO., LTD.",8,1520,328,1848
2906,449820,Daughter of Shadows: An SCP Breach Event,0,False,Blackrose Industries,5,21,27,48
2907,449960,Book of Demons,0,False,Thing Trunk,8,3553,388,3941
2908,450020,DAMAGE CONTROL,0,False,Ross Edgar,0,0,1,1
2909,450040,Stealth Labyrinth,0,False,Reddoll Srl,4,2,8,10
2910,450050,Yon Paradox,0,False,Digital Mantis,5,12,17,29
2911,450060,Insane Decay of Mind: The Labyrinth,0,False,GoManga Interactive,5,12,11,23
2912,449300,Planar Conquest,0,False,Wastelands Interactive,5,104,89,193
2913,449310,Spunk and Moxie,0,False,Chocolate Homunculus,0,2,1,3
2914,449320,Dino Eggs: Rebirth,0,False,David H Schroeder,0,6,3,9
2915,449330,Grid Masters,0,False,"Angry Hangar Games, LLC",0,2,2,4
2916,449340,Serafina's Crown,0,False,Woodsy Studio,7,14,0,14
2917,449350,Backstreets of the Mind,0,False,SiBear Games,5,8,7,15
2918,449450,SPLIT BULLET,0,False,IndigoBlue Game Studio,5,9,4,13
2919,449460,Commands & Colors: The Great War,0,False,HexWar Games,5,37,21,58
2920,449470,Atulos Online,0,True,Parallaxian Pty Ltd,0,2,0,2
2921,449500,Hush Hush - Unlimited Survival Horror,0,False,MediaAtlas,0,1,3,4
2922,449510,The Crow's Eye,0,False,3D2 Entertainment,5,31,17,48
2923,449520,Rush for gold: California,0,False,Rainbow Games,0,2,2,4
2924,449530,Grand Pigeon's Duty,0,False,WolfgangIs,5,75,39,114
2925,449540,There's Poop In My Soup,0,False,K Bros Games,8,1501,178,1679
2926,449560,Space Ranger ASK,0,False,The Mojo Collective,0,1,0,1
2927,449610,Monster Boy and the Cursed Kingdom,0,False,Game Atelier,8,480,57,537
2928,449640,Bloody Zombies,0,False,Paw Print Games Ltd.,6,19,8,27
2929,448780,Sixtieth Kilometer,0,False,Talentplace,6,218,71,289
2930,448790,Infinity Wings - Scout & Grunt,0,False,XiNFiNiTY Games,0,3,4,7
2931,448800,Semispheres,0,False,Vivid Helix,7,24,4,28
2932,448810,Torgar's Quest,0,False,Tagunda LLC,6,8,3,11
2933,448820,Planet in the Shadows,0,False,Sergey Bobrov,6,7,3,10
2934,448830,ASMR Universe,0,False,Colossal Wreck,5,16,9,25
2935,448850,Overload,0,False,"Revival Productions, LLC",8,922,59,981
2936,448880,Spells 'n' Stuff,0,False,Sour Soup Games,0,2,2,4
2937,448910,Axes and Acres,0,False,BrainGoodGames,8,69,10,79
2938,448960,"I, Hope",0,False,Kenny Roy,7,11,1,12
2939,448990,Phlyndir,0,False,Kabertek,0,1,1,2
2940,449020,The Bottom of the Well,0,True,Red Nettle Studio,0,3,1,4
2941,449040,Jesus Christ RPG Trilogy,0,True,Wholetone Games,7,18,3,21
2942,449050,Rock Paper Scissors Champion,0,True,Wholetone Games,0,1,1,2
2943,449060,Cellar,0,False,Vertical Skull Games,8,63,12,75
2944,449070,YEARN Tyrant's Conquest,0,False,TripleRam Games,0,2,5,7
2945,449090,Zombie Parking,0,False,XPAGAME,5,25,11,36
2946,449120,Nanobots,0,False,Diego Rodrigues,0,5,4,9
2947,449140,Istrolid,0,True,treeform,7,30,3,33
2948,449150,pimeja nasa (PataNoir),0,False,Simon Christiansen,0,6,2,8
2949,449160,Land it Rocket,0,False,Petite Games,0,6,0,6
2950,449170,Gnomes Garden 2,0,False,Jerzie,7,35,2,37
2951,449180,Meld,0,False,Axis Games,0,3,0,3
2952,449200,Calcu-Late,0,False,Blazing Fanfish,4,9,15,24
2953,449210,Verdict Guilty - 유죄 평결,0,False,Retro Army Limited,8,207,26,233
2954,449220,A grande bagunça espacial - The big space mess,0,False,RMAL,7,25,4,29
2955,449240,Stormworm+,0,True,Afrobeast Games,0,5,0,5
2956,449250,A Little Lily Princess,0,False,Hanabira,8,161,9,170
2957,448280,Job Simulator,0,False,Owlchemy Labs,8,1685,168,1853
2958,448290,Nefarious,0,False,StarBlade,8,220,41,261
2959,448300,Logic Missile,0,False,Bouchard Industries,0,0,1,1
2960,448310,Bitardia Cards: Memes of 2ch,0,True,varlamov5264,0,1,2,3
2961,448370,IS Defense,0,False,Destructive Creations,8,641,48,689
2962,448380,Escape: Close Call,0,False,Tarboosh Games,7,10,1,11
2963,448400,Hidden Object 6-in-1 bundle,0,False,Alawar Entertainment,6,72,22,94
2964,448440,Bizarre Earthquake,0,False,Proximity Games,5,38,38,76
2965,448470,Bacteria,0,False,Sometimes You,5,18,16,34
2966,448480,Caravanserail,0,False,Jerome Bodin,5,5,5,10
2967,448500,Little Walker,0,False,Blake Fix,7,15,1,16
2968,448510,Overcooked,0,False,Ghost Town Games Ltd.,8,3445,265,3710
2969,448520,Deranged Rabbits,0,False,Mikko Nykyri,0,8,0,8
2970,448530,Square's Route,0,False,Black Death Apps Limited,0,7,1,8
2971,448540,Terror Lab,0,False,Nicolas Bernard,5,16,16,32
2972,448550,Minimal,0,False,Gammosaur,0,5,1,6
2973,448560,Mind Games,0,False,AK Games,5,21,27,48
2974,448580,Dead End Road,0,False,DDD Wares,8,130,18,148
2975,448610,Draw Rider,0,False,17Studio,5,35,19,54
2976,448620,Rebirth of Island,0,False,Yo_Serjio,4,6,16,22
2977,448630,Rabiez: Epidemic,0,False,Sekerin Productions,4,10,23,33
2978,448640,Elements II: Hearts of Light,0,False,Soul Catapult,6,16,6,22
2979,448650,GEO Master,0,False,Anthony KOZAK,6,15,4,19
2980,448670,Pinball HD Collection,0,False,OOO Gameprom,5,20,21,41
2981,448690,Lionessy Story,0,False,Maltakreuz,5,5,5,10
2982,448710,VirZOOM Arcade,0,True,VirZOOM,0,2,0,2
2983,448720,Puzzle Box,0,False,BplusGames,6,7,3,10
2984,448730,"Imhotep, Pyramid Builder",0,False,Game Studio Abraham Stolk Inc.,5,6,4,10
2985,448750,Infinity Saga,0,False,ArcticFox223,0,5,4,9
2986,448110,So Long Earth,0,True,Ed Farage,0,4,2,6
2987,448140,Night light,0,False,Nightmaker,0,0,3,3
2988,448150,Mystica: The Ninth Society,0,False,Bread Vision Studios LLC.,5,18,8,26
2989,448160,WOLFLAME,0,False,ASTRO PORT,7,40,4,44
2990,448170,Last Dream: World Unknown,0,False,White Giant RPG Studios,7,33,8,41
2991,448230,AsteroidsHD,0,False,NewWorldCoders,5,4,6,10
2992,448240,Hybrid Animals,0,False,FamishedMammal,5,165,122,287
2993,447690,Dimensional Intersection,0,False,DNV,6,23,8,31
2994,447700,Crystal Crisis,0,False,"Nicalis, Inc.",8,50,10,60
2995,447780,LostWinds,0,False,Frontier Developments,8,124,25,149
2996,447800,LostWinds 2: Winter of the Melodias,0,False,Frontier Developments,8,59,14,73
2997,447820,Day of Infamy,0,False,New World Interactive,8,7940,1256,9196
2998,447850,The Next Door,0,False,Labory,5,9,13,22
2999,447860,Maria the Witch,0,False,Naps Team,5,9,7,16
3000,447890,Cat on a Diet,0,False,Nawia Games,6,130,52,182
3001,447920,Drift (Over) Drive,0,False,Retraissance,3,1,9,10
3002,447930,LYDIA: SWEET DREAMS,0,False,C-DRIVE MEDIA ART,0,2,0,2
3003,447940,Brine,0,False,BrineTeam,0,0,4,4
3004,447950,Bad Caterpillar,0,False,Fun Infused Games,7,22,2,24
3005,447960,XCavalypse,0,False,davevillz,5,15,10,25
3006,447980,Blast Brawl 2,0,False,Mind's Eye Games,7,10,0,10
3007,447990,Spectrubes,0,False,The Light Sword Team,0,1,0,1
3008,448000,Sparkle ZERO,0,False,MMEU,5,27,35,62
3009,448010,RePete,0,False,Luke Godfrey,7,11,2,13
3010,448020,Share,0,False,HFM Games,5,21,29,50
3011,448050,Mr Nibbles Forever,0,False,Epic Shrimp,7,12,3,15
3012,448060,X-17,0,False,Panzer Gaming Studios,4,5,13,18
3013,448070,Red Risk,0,False,Microblast Games,5,36,46,82
3014,448080,Fibbage XL,0,False,"Jackbox Games, Inc.",8,153,8,161
3015,448090,Virtual Rogue,0,False,Snowy Productions,0,4,4,8
3016,447170,"Destiny's Princess: A War Story, A Love Story",13,False,Dogenzaka Lab,5,63,37,100
3017,447180,My Secret Pets!,13,False,Dogenzaka Lab,5,43,25,68
3018,447190,Pub Encounter,13,False,Dogenzaka Lab,8,87,19,106
3019,447200,The Men of Yoshiwara: Ohgiya,13,False,Dogenzaka Lab,8,79,11,90
3020,447210,Blink,0,False,nextReality Games,7,35,3,38
3021,447240,Zasa - An AI Story,0,False,Rainssong,7,13,1,14
3022,447270,IKEA VR Experience,0,True,IKEA Communications AB,0,2,0,2
3023,447290,Redeemer: Enhanced Edition,0,False,Sobaka Studio,8,474,94,568
3024,447310,Paper Train Traffic,0,False,isTom Games Kft.,6,33,12,45
3025,447530,VA-11 Hall-A: Cyberpunk Bartender Action,0,False,Sukeban Games,9,8090,242,8332
3026,447540,Lost Cosmonaut,0,False,Charlie Evans,0,0,2,2
3027,447570,Regeria Hope Episode 1,0,True,Golden Game Barn,0,5,0,5
3028,446610,Bunny Bounce,0,False,Dharker Studio,5,16,13,29
3029,446620,Zombie Training Simulator,0,False,"Acceleroto, Inc.",8,173,15,188
3030,446640,Space Pilgrim Episode IV: Sol,0,False,Pilgrim Adventures,8,127,9,136
3031,446760,Neighborhorde,0,False,Fermenter Games,7,14,2,16
3032,446770,Skeet: VR Target Shooting,0,True,Flatbox Studios,0,3,0,3
3033,446790,Diluvion: Resubmerged,0,False,Arachnid Games,5,296,156,452
3034,446800,Transport Fever,0,False,Urban Games,8,3055,739,3794
3035,446810,Blossom Tales: The Sleeping King,0,False,"Castle Pixel, LLC.",8,139,26,165
3036,446830,The Lonesome Fog,0,False,Might and Delight,7,39,5,44
3037,446840,Splasher,0,False,Splashteam,8,83,3,86
3038,446850,Mindball Play,0,False,Mentalytics Team,7,16,1,17
3039,446870,Glitchrunners,0,False,Torque Studios,4,3,8,11
3040,446910,Night Blights,0,False,Trapdoor Games,7,47,1,48
3041,446990,The Huntsman: Winter's Curse,0,True,Desert Owl Games LLC,7,41,8,49
3042,447000,Grimsfield,0,False,Adam Wells,7,15,1,16
3043,447020,Farming Simulator 17,0,False,GIANTS Software,8,5614,458,6072
3044,447040,Watch_Dogs® 2,0,False,Ubisoft,8,11592,2614,14206
3045,447100,XLR,0,False,"Metaware Limited, LLC",4,5,13,18
3046,447120,Where the Water Tastes Like Wine,0,False,Dim Bulb Games,8,321,75,396
3047,446240,Trawl,0,False,Daniel Gallagher,5,11,7,18
3048,446250,Silver Bullet: Prometheus,0,False,Byulbram,7,8,2,10
3049,446310,Sabres of Infinity,0,False,Hosted Games,8,91,5,96
3050,446380,Sophie's Curse,0,False,TrerPlay,8,128,21,149
3051,446390,Onechanbara Z2: Chaos,16,False,Tamsoft,6,194,75,269
3052,446430,Doctor Watson - Treasure Island,0,False,United Independent Entertainment GmbH,0,0,1,1
3053,446440,Doctor Watson - The Riddle of the Catacombs,0,False,United Independent Entertainment GmbH,0,0,1,1
3054,446450,Blaster Simulator,0,False,United Independent Entertainment GmbH,0,2,4,6
3055,446460,Highland Warriors,0,False,United Independent Entertainment GmbH,0,5,1,6
3056,446470,New York Taxi Simulator,0,False,Little Freedom Factory,0,3,4,7
3057,446480,New York Bus Simulator,0,False,Little Freedom Factory,0,1,5,6
3058,446490,Rail Cargo Simulator,0,False,United Independent Entertainment GmbH,0,3,6,9
3059,446510,Armed and Gelatinous,0,False,Three Flip Studios,0,2,0,2
3060,446540,Smash Up,0,False,Nomad Games,5,37,28,65
3061,446550,Infinite Mini Golf,0,False,Zen Studios,5,36,17,53
3062,446560,Just Dance 2017,0,False,Ubisoft Paris,6,203,81,284
3063,446570,Grove - VR Browsing Experience,0,False,Mure VR,0,0,4,4
3064,446590,7 Mages,0,False,"Napoleon Games, s.r.o.",5,25,20,45
3065,446600,Magi Trials,0,False,Dharker Studio,8,57,12,69
3066,445750,Settled,18,False,Allen Dayan,8,55,9,64
3067,445770,Airport Madness 3D,0,False,Big Fat Simulations Inc.,8,158,27,185
3068,445800,Love Language Japanese,0,False,Papurika.moe,8,93,18,111
3069,445840,Undead vs Plants,0,False,Peaksel D.O.O. Nis,0,1,0,1
3070,445860,Toy Plane Heroes,0,False,Oasis VR,6,20,7,27
3071,445950,Asher,0,False,Danl2o2o,7,10,1,11
3072,445980,Wizard of Legend,0,False,Contingent99,8,3958,347,4305
3073,446000,Stellar Monarch,0,False,Silver Lemur Games,6,115,39,154
3074,446010,CitiesCorp Concept - Build Everything on Your Own,0,False,SaintWorks,0,2,3,5
3075,446020,Jalopy,0,False,Minskworks,6,2381,673,3054
3076,446040,Blade Arcus from Shining: Battle Arena,0,False,Studio Saizensen,8,46,11,57
3077,446050,Operation KREEP,0,False,Magic Item Tech,0,2,2,4
3078,446060,akeytsu Indie 2017,0,False,nukeygara,7,23,1,24
3079,446070,ecotone,0,False,Sundae Factory,7,10,1,11
3080,446100,Mantis Burn Racing®,0,False,VooFoo Studios,6,29,9,38
3081,446110,Happy Critters,0,False,Dreamatrix,0,1,0,1
3082,446120,Bunker Punks,0,False,Ninja Robot Dinosaur,6,179,52,231
3083,445550,Watson's Watch,0,False,Retro Warp Gaming,0,2,0,2
3084,445600,Void Raiders,0,False,Tryzna83,5,27,16,43
3085,445670,The Stargazers,0,False,Lupiesoft,5,5,7,12
3086,445720,Battle Islands: Commanders,0,True,DR Studios,4,6,17,23
3087,445040,Sorcery! Part 3,0,False,inkle Ltd,8,50,4,54
3088,445050,Paintey,0,False,Brian Lindenhof,0,1,1,2
3089,445070,Tatsu,0,False,BlueLine Games,6,12,5,17
3090,445110,Tasty Planet: Back for Seconds,0,False,Dingo Games,8,194,21,215
3091,445130,The Average Everyday Adventures of Samantha Browne,0,True,Lemonsucker Games,5,8,4,12
3092,445140,Smell Of Death,0,False,Alkame Games,5,22,11,33
3093,445170,The Haunting of Billy Classic,0,False,Targon Studios,7,10,0,10
3094,445190,Expeditions: Viking,0,False,Logic Artists,8,1202,241,1443
3095,445210,Tiny Knight,0,False,Convex,6,10,4,14
3096,445230,Lost girl`s [diary],16,True,SmoleVN,0,5,3,8
3097,445310,Might and Magic: Heroes VII – Trial by Fire,0,False,Limbic Entertainment,5,198,139,337
3098,445350,Atomic Space Command,0,False,"No, You Shut Up Inc.",0,2,6,8
3099,445430,Seinarukana -The Spirit of Eternity Sword 2-,0,False,Xuse,6,10,3,13
3100,444550,Void 21,0,False,Taranasus Studio,7,9,2,11
3101,444580,ALONE IN SPACE,0,False,Butterflyware,4,26,47,73
3102,444590,Skautfold: Shrouded in Sanity,0,False,Steve Gal,8,209,44,253
3103,444620,SpellKnights,0,True,Mechanical Boss,0,1,0,1
3104,444640,Bloons TD Battles,0,True,Ninja Kiwi,8,230,35,265
3105,444650,Endciv,0,False,Crowbox,5,16,19,35
3106,444690,TRAPPED,0,False,Cheap Fun Games,5,44,37,81
3107,444710,Battle Crust,0,False,Picorinne Soft,7,19,0,19
3108,444720,Inexistence,0,False,Jonathan BRASSAUD,5,87,62,149
3109,444740,Cologne,0,False,Nhneno Games,0,1,2,3
3110,444770,Mimpi Dreams,0,True,Dreadlocks Mobile,8,45,7,52
3111,444800,NO THING,0,False,Evil Indie Games,8,126,13,139
3112,444830,Concrete and Steel,0,False,Bad Dinosaur,0,6,3,9
3113,444870,Combat Racers,0,False,The Major Game Company,0,2,1,3
3114,444880,Death Stair,0,False,Fun Sponge Games,6,88,30,118
3115,444940,UBERMOSH:BLACK,0,False,Walter Machado,8,119,21,140
3116,444950,Let's Eat! Seaside Cafe,0,False,Inu to Neko,0,1,1,2
3117,444970,SPATIAL SOUND CARD,0,False,NEW AUDIO TECHNOLOGY,6,73,26,99
3118,444990,Ad Exitum,0,False,Since Idea Games,0,0,2,2
3119,445000,Nova Nukers!,0,False,Alchemist Interactive,0,4,1,5
3120,445020,Frozen Synapse 2,0,False,Mode 7,5,114,61,175
3121,444130,Auralux: Constellations,0,False,War Drum Studios,6,44,16,60
3122,444140,Sonicomi,0,False,Nitroplus,8,220,25,245
3123,444160,Bonsai,0,False,Rooted Concepts,5,20,24,44
3124,444170,Unhack 2,0,False,InvertMouse,7,42,1,43
3125,444180,Techwars Online,0,False,Argus Games,5,32,15,47
3126,444190,Princess Edge - Dragonstone,0,False,erobotan,7,10,2,12
3127,444210,Strike Force: Desert Thunder,0,False,West Forest Games,0,0,5,5
3128,444220,Asteroid Bounty Hunter,0,False,EGAMER,5,53,45,98
3129,444260,Mindless Running,0,False,Quiet River,5,63,53,116
3130,444270,Hypersensitive Bob,0,False,SIEIDI Ltd,6,12,4,16
3131,444280,Alice's Patchwork,0,False,Creobit,7,37,5,42
3132,444320,Jumpix Jump,0,False,Seaside Digital Arts,5,12,16,28
3133,444330,Battleships at Dawn!,0,False,Mintaka Softworks,0,1,0,1
3134,444350,HACK_IT,0,False,Dan_D,4,22,81,103
3135,444410,Find Out,0,False,Vorobiov Vadym,5,8,8,16
3136,444420,24 Hours 'til Rescue,0,False,J. Fletcher,3,2,12,14
3137,444430,Zeus vs Monsters - Math Game for kids,0,False,Peaksel,7,9,2,11
3138,444440,Scapeland,0,False,3100 games,4,5,9,14
3139,444460,Love is Blind: Mutants,0,False,Hybriona Labs,3,3,25,28
3140,444470,Moor,0,False,Fredrik,0,3,2,5
3141,444480,Broken Dreams,0,False,Mihai Morosanu,5,50,34,84
3142,444520,Leave Me Alone: A Trip To Hell,0,False,Lisa Voronova,5,8,6,14
3143,444530,Light Repair Team #4,0,False,Eerie Bear Games,7,34,3,37
3144,443700,The Inner Sea,0,False,dsquare,5,9,4,13
3145,443800,Ruckus Ridge VR Party,0,False,Foreignvr,5,29,16,45
3146,443810,This Is the Police,0,False,Weappy Studio,6,1760,626,2386
3147,443830,The Daring Mermaid Expedition,0,False,Choice of Games,5,10,7,17
3148,443850,Tross,0,False,Shadowprerequisite,5,6,6,12
3149,443860,Riptide GP: Renegade,0,False,Vector Unit,8,98,11,109
3150,443880,Loot Rascals,0,False,Hollow Ponds,7,36,4,40
3151,443970,S2ENGINE HD,0,False,Profenix Studio SRLS,5,80,36,116
3152,443980,Burokku Girls,18,False,Silver Cow Studio,5,19,9,28
3153,444000,Super Night Riders,0,False,neko.works,8,85,8,93
3154,444020,Coffee Pot Terrarium,0,False,Brothers Flint,0,3,3,6
3155,443250,Legacy of the Elder Star,0,True,Kickbomb Entertainment LLC,5,7,4,11
3156,443260,Hero Generations: ReGen,0,False,Heart Shaped Games LLC,5,21,14,35
3157,443330,Malus Code,16,False,"M2 Co.,LTD",6,46,19,65
3158,443360,Red Comrades 2: For the Great Justice. Reloaded,0,False,Buka Development,5,7,7,14
3159,443370,The Treasures of Montezuma 5,0,False,Wellore,5,16,12,28
3160,443380,Tokyo Babel,0,False,propeller,8,45,7,52
3161,443420,Artificial Defense,0,False,"Thiemo Bolder, ONEMANGAMES",6,36,11,47
3162,443450,LASTFIGHT,0,False,Piranaking,6,21,9,30
3163,443460,Star Sky 2,0,False,Mårten Jonsson,7,15,2,17
3164,443570,DreamBreak,0,False,Aist,6,7,3,10
3165,443580,Antenna,0,True,LWNA,6,14,6,20
3166,443630,Chicku,0,False,Gatling Goat Studios,7,16,3,19
3167,443650,Wailing Heights,0,False,Outsider Games,6,46,18,64
3168,442710,Fantasy Tales Online,0,True,Cold Tea Studio,0,4,0,4
3169,442760,Endless Burst,0,False,Neon Squid Games,0,0,2,2
3170,442770,The Minims,0,False,beyondthosehills,5,5,5,10
3171,442780,STRAFE: Gold Edition,0,False,Pixel Titans,6,913,302,1215
3172,442810,UFO Online: Invasion,0,True,Bad Pixel,0,0,3,3
3173,442890,Magic Potion Explorer,0,False,ARTIFACTS,5,27,20,47
3174,443020,Victory and Glory: Napoleon,0,False,Electric Games,6,53,16,69
3175,443070,Insane Insects: The Inception,0,False,Bad Cast games,0,0,3,3
3176,443110,Armored Warfare,0,True,Obsidian Entertainment,0,1,0,1
3177,442500,Age of Gladiators,0,False,Creative Storm Entertainment,6,311,98,409
3178,442660,The SoulKeeper VR,0,False,HELM Systems,5,31,20,51
3179,442000,Alone K.W.,0,False,TeamWaterFly,3,1,17,18
3180,442070,Drawful 2,0,False,"Jackbox Games, Inc.",8,509,45,554
3181,442120,Pinball FX3,0,True,Zen Studios,8,439,27,466
3182,442140,Dyadic,0,False,Handsome Dragon Games,0,5,3,8
3183,442190,Mind Dead,0,False,GBROSSOFT,0,2,3,5
3184,442210,Switchcars,0,False,Altfuture,8,83,9,92
3185,442220,Iron Madness,0,True,Inane Games,0,5,3,8
3186,442260,Sprinter,0,False,Light Step Games,0,7,1,8
3187,442290,Pointless,0,True,Cake Collective Games,5,22,12,34
3188,441550,STAR WARS™ Rebellion,0,False,Coolhand Interactive,8,450,67,517
3189,441640,VALENS,0,False,Digitallion,3,1,9,10
3190,441670,Jelly Killer,0,False,Immortal Game Studio,6,67,26,93
3191,441680,Obscuritas,0,False,VIS-Games,5,15,11,26
3192,441770,MindTex 2,0,False,Frozen Flame,7,42,3,45
3193,441790,Fragmented,0,False,Above and Beyond Technologies,4,174,363,537
3194,441830,I am Setsuna,0,False,Tokyo RPG Factory,6,654,276,930
3195,441850,ScriptVOX Studio,0,False,Screaming Bee,0,0,1,1
3196,441870,OutDrive,0,False,DNVR Prod,6,951,384,1335
3197,441230,Babel: Tower to the Gods,0,False,Ruce,7,20,4,24
3198,441250,Talewind,0,False,WindLimit,5,15,17,32
3199,441280,Pharaoh Rebirth+,0,False,KROBON station,8,147,17,164
3200,441350,Assault Suit Leynos,0,False,Dracue Software,6,44,16,60
3201,441440,Sometimes Always Monsters,0,False,Vagabond Dog,5,62,27,89
3202,441510,The Incredible Baron,0,False,FlatRedBall,0,5,1,6
3203,440690,Mesel,0,False,Burak Dabak,6,12,4,16
3204,440730,Survival Zombies The Inverted Evolution,0,False,Racing Bros,5,203,156,359
3205,440740,Epic battles within 5 seconds!,0,True,YFC games,0,2,1,3
3206,440750,Story of a Cube,0,False,TinyAtomGames,0,5,2,7
3207,440760,Cube Destroyer,0,False,Freedomize Studio,6,158,41,199
3208,440770,Drawn Story,0,False,Vitaly Rekubratskiy,0,1,5,6
3209,440790,Spellbind : Luppe's tale,0,False,Spider Key Games,0,1,2,3
3210,440800,Trial by Viking,0,False,Last Life Games,0,4,1,5
3211,440810,1943 Megami Strike,0,False,GameUS Inc,4,5,13,18
3212,440870,Mysteries of the Past: Shadow of the Daemon Collector's Edition,0,False,Blue Brain Games,6,15,6,21
3213,440880,The Count Lucanor,0,False,Baroque Decay,8,339,24,363
3214,440950,Story Of the Survivor,0,False,Kamil Szczepanik,5,7,6,13
3215,441010,Mount Your Friends 3D: A Hard Man is Good to Climb,0,False,Stegersaurus Software Inc.,8,165,16,181
3216,441050,Polandball: Can into Space!,0,False,Alien Pixel Studios,8,263,19,282
3217,441060,Silver Creek Falls - Chapter 3,0,False,Sapphire Dragon Productions,6,17,7,24
3218,440280,Overpower,0,False,Hydrant Games,7,12,2,14
3219,440340,Banzai Escape,0,False,XenoAisam,5,26,13,39
3220,440380,Super Kitty Boing Boing,0,False,Pixelated Panties,0,3,0,3
3221,440410,Wolfsong,0,False,Hyptosis,6,7,3,10
3222,440420,True Fear: Forsaken Souls Part 1,0,False,Goblinz,8,230,24,254
3223,440450,Escape: Sierra Leone,0,False,Reborn Games Inc.,5,16,12,28
3224,440470,Absence,0,False,Samuel Sprague,0,0,4,4
3225,440520,VirtualHere For Steam Link,0,False,VirtualHere Pty. Ltd.,5,105,123,228
3226,440540,Ara Fell: Enhanced Edition,0,False,Stegosoft Games,9,686,30,716
3227,440630,The Brookhaven Experiment,0,False,Phosphor Games,8,496,80,576
3228,440640,Sweet F. Cake,0,False,Texic,7,18,2,20
3229,440650,Niche - a genetics survival game,0,False,Stray Fawn Studio,8,2659,265,2924
3230,440660,Void Vikings,0,False,"Ugly Beard Games, LLC",7,14,2,16
3231,439750,The Lost Heir 2: Forging a Kingdom,0,False,Hosted Games,6,21,8,29
3232,439770,The Lost Heir: The Fall of Daria,0,False,Hosted Games,6,34,11,45
3233,439800,Clouds & Sheep 2,0,False,HandyGames,7,13,3,16
3234,439880,Heroes of Loot 2,0,False,Orangepixel,7,9,1,10
3235,439910,Risky Rescue,0,False,Digital Melody,6,64,19,83
3236,439920,Royal Heroes,0,False,Badim,6,69,23,92
3237,439930,Control Craft 2,0,False,Cristian Manolachi,4,12,19,31
3238,439940,Lucid9: Inciting Incident,0,True,Fallen Snow Studios,7,8,2,10
3239,439960,Falling Stars: War of Empires,0,False,Riveted Games,5,6,4,10
3240,440020,bit Dungeon+,0,False,Dolores Entertainment,4,22,39,61
3241,440100,Fall of Gyes,0,False,Black Cloud Studios,0,2,1,3
3242,439250,Space Pilgrim Episode III: Delta Pavonis,0,False,Pilgrim Adventures,8,109,8,117
3243,439310,Until I Have You,0,False,Wormwood Studios,5,61,27,88
3244,439340,Tavern Tycoon - Dragon's Hangover,0,False,Terapoly,5,348,166,514
3245,439370,Midair,0,True,Archetype Studios,6,58,18,76
3246,439420,SteelLIFE,0,False,AxiPLAY,0,3,3,6
3247,439440,Of Carrots And Blood,0,False,Trite Games,6,14,5,19
3248,439460,Ships 2017,0,False,FragOut,4,25,39,64
3249,439490,BLUE REVOLVER,0,False,Stellar Circle,8,198,2,200
3250,439530,Rock-N-Rogue: A Boo Bunny Plague Adventure,0,False,On the Level Game Studios,5,6,6,12
3251,439550,'n Verlore Verstand,0,False,Skobbejak Games,4,13,22,35
3252,439720,Unending Galaxy,0,False,Anarkis Gaming,5,46,31,77
3253,439730,XO-Planets,0,False,Bohfam,0,4,1,5
3254,438770,Street Posse Showdown,0,False,LS Ensemble,0,0,2,2
3255,438780,Terrarium Land,0,False,Layer games,0,0,1,1
3256,438790,Random Access Murder,0,False,Team Murder,0,2,5,7
3257,438820,Hyper Box,0,False,Pixelated Cupcake,6,12,4,16
3258,438910,"Hack, Slash & Backstab",0,False,MAGIC Spell Studios,0,1,5,6
3259,438920,Legends of Callasia,0,True,Boomzap Entertainment,7,28,7,35
3260,438940,XBlaze Lost: Memories,0,False,Arc System Works,7,11,1,12
3261,439190,Stories: The Path of Destinies,0,False,Spearhead Games,8,882,150,1032
3262,438240,Corpo Tale,0,False,hamstercube,0,1,0,1
3263,438260,Rewind,0,False,Stubborn Horse Studios,6,7,3,10
3264,438270,Learn Japanese To Survive! Hiragana Battle,0,False,Sleepy Duck,8,1085,91,1176
3265,438300,Shepherds of the Abyss,0,False,Impulse Games,5,9,6,15
3266,438310,SCORE,0,False,TecEh! Studios,5,10,11,21
3267,438320,Rush Rover,0,False,radio,8,64,7,71
3268,438340,Drizzlepath: Genie,0,False,Tonguç Bodur,5,45,31,76
3269,438350,Dynetzzle Extended,0,False,Vishnu Vadakke Pariyarath,7,18,2,20
3270,438360,Infinitesimal Point,0,False,Small Room Games,0,2,2,4
3271,438420,Zenith,0,False,Infinigon,5,95,49,144
3272,438430,Valentino Rossi The Game,0,False,Milestone S.r.l.,6,74,20,94
3273,438440,Star Rogue,0,False,Wehrmann Studios,0,3,0,3
3274,438450,3DF Zephyr Lite Steam Edition,0,False,3Dflow SRL,7,29,0,29
3275,438460,ARENA 3D,0,False,Mike Bushell,7,21,4,25
3276,438490,GOD EATER 2 Rage Burst,0,False,BANDAI NAMCO Studio,8,1313,212,1525
3277,438600,Soccer Manager,0,False,Soccer Manager Ltd,0,4,0,4
3278,438640,LEGO® STAR WARS™: The Force Awakens,0,False,Traveller's Tales,6,1195,334,1529
3279,438650,Gravity Compass,0,False,NovaWake Studios,5,7,6,13
3280,438660,Jerry Rice & Nitus' Dog Football,0,False,JUDOBABY INC.,7,21,2,23
3281,438680,One Troll Army,0,True,FlyAnvil,6,10,3,13
3282,438720,Heroes of Shadow Guard,0,True,Iron 27,0,1,0,1
3283,438730,Poly Towns,0,False,Red Phoenix Studios,5,10,8,18
3284,438740,Friday the 13th: The Game,0,False,IllFonic,6,11635,4032,15667
3285,437870,Earth Space Colonies,0,False,Persona and Pixel studio,5,34,47,81
3286,437880,Project Graviton,0,False,Enter Main Loop,0,7,0,7
3287,437900,Party Jousting,0,True,vikingfabian.com,0,6,3,9
3288,437920,Tricky Towers,0,False,WeirdBeard,8,983,143,1126
3289,438000,PIXELMAN,0,False,Kindermann Corp.,7,19,3,22
3290,438010,PulseCharge,0,False,Frozenmark Games,4,8,22,30
3291,438020,AI: Rampage,0,False,Sekerin Productions,4,13,52,65
3292,438030,Dead6hot,0,False,Chuck Productions,4,35,70,105
3293,438040,Shakes and Fidget,0,True,Playa Games GmbH,5,35,16,51
3294,438080,Surfingers,0,False,Digital Melody,8,97,24,121
3295,438090,Defend Felinearth,0,False,Sixth Line Studios,0,0,3,3
3296,438110,CV Maker for Windows,0,False,Individual Software,0,2,3,5
3297,438130,Root Double -Before Crime * After Days- Xtend Edition,0,False,Yeti,8,128,11,139
3298,438160,LILT,0,False,pho,0,3,0,3
3299,438180,Super Mustache,0,False,Redro Games,5,79,38,117
3300,438220,Castle Heist: Chapter 1,0,False,"Gustav ""Goffa"" Söderström",0,4,3,7
3301,437340,Toys of War,0,False,2Bit Studios,0,2,0,2
3302,437380,Vanquish: The Adventures of Lady Exton,0,False,Runestone Studios,0,5,0,5
3303,437390,HoPiKo,0,False,Laser Dog,7,10,2,12
3304,437420,The Secret Order 3: Ancient Times,0,False,Sunward Games,8,73,12,85
3305,437520,ZeGame,0,False,Jesper The End,7,37,2,39
3306,437530,A Blind Legend,0,False,Dowino,6,43,17,60
3307,437550,Melon Simulator™,0,False,Delirious & Co.,7,35,8,43
3308,437570,GoNNER (GONNER2 Out Now!),0,False,Art in Heart,8,370,57,427
3309,437610,SQUIDS FROM SPACE,13,True,Fun Bits,7,36,3,39
3310,437630,State of Mind,0,False,Daedalic Entertainment,8,262,62,324
3311,437690,Venture Kid,0,False,Snikkabo AS,7,33,6,39
3312,437710,Magic Flute,0,False,LabLike Sp. z o.o.,0,3,0,3
3313,437720,Blossoms Bloom Brightest,0,True,Reine Works,0,1,0,1
3314,437730,Roadclub: League Racing,0,False,Solid Core,6,18,5,23
3315,437740,Inside: Before Birth,0,False,CydoniaGate,4,5,11,16
3316,436950,Mosaic Maze,0,False,Raw Lion Workshop,0,1,1,2
3317,437000,GUILTY GEAR 2 -OVERTURE-,0,False,Arc System Works,6,67,23,90
3318,437020,WITCH-BOT MEGLILO,0,False,ASTRO PORT,7,44,3,47
3319,437030,MEMENTO,0,False,CreateLab,6,11,4,15
3320,437060,MOAI 3: Trade Mission Collector's Edition,0,False,Toyman Interactive,7,13,2,15
3321,437080,Space Rift - Episode 1,0,False,Vibrant Core,5,25,12,37
3322,437090,Wobbly Jungle,0,False,Sourena Game Studio,0,1,1,2
3323,437100,My Night Job,0,False,Webcore Games,7,16,3,19
3324,437160,The Lion's Song: Episode 1 - Silence,0,True,Mi'pu'mi Games GmbH,8,154,9,163
3325,437170,The Amazing Adventures of Ash - Afterparty,0,False,Z3roram Studios,0,5,2,7
3326,437180,Chill the Piro,0,False,Sergey Marchenko,0,3,0,3
3327,437210,The Hunt,0,False,Bass Pro Shops,6,7,3,10
3328,437220,The Culling,0,False,Xaviant,5,4890,3553,8443
3329,437250,A House of Many Doors,0,False,Pixel Trickery,8,231,46,277
3330,436670,The Legend of Heroes: Trails in the Sky the 3rd,0,False,Nihon Falcom,8,724,39,763
3331,436680,A More Beautiful World - A Kinetic Visual Novel,0,False,Afterthought Studios,0,0,1,1
3332,436690,Tempest Citadel,0,False,Aartform Games,6,12,5,17
3333,436820,Waltz of the Wizard (Legacy demo),0,True,Aldin Dynamics,7,20,0,20
3334,436850,Stellar Stars,0,False,WhiteSponge,0,1,0,1
3335,436860,Arctic alive,0,False,Tort,5,15,14,29
3336,436870,Tank Brawl,0,False,Phung Games,5,8,4,12
3337,436940,Quar: Battle for Gate 18,0,False,Steel Wool Studios,7,41,4,45
3338,436320,Raw Data,0,False,Survios,8,1346,279,1625
3339,436340,Kiya,0,True,Emblematic Group,0,2,0,2
3340,436360,Robo's World: The Zarnok Fortress,0,False,Bluish-Green Productions,0,3,1,4
3341,436390,Prison Run and Gun,0,False,Quantized Bit,8,120,10,130
3342,436400,Heroes of the Seven Seas VR,0,False,Mirage Interactive,7,21,4,25
3343,436410,Beyond The Destiny,0,False,BTD Team,0,1,5,6
3344,436470,Gamma Bros,0,True,Pixeljam,7,13,1,14
3345,436480,Soup: the Game,0,False,Dewdrop Games,5,11,6,17
3346,436490,Firebird - La Peri,0,False,InnerspaceVR,6,104,31,135
3347,436500,Diaries of a Spaceport Janitor,0,False,Sundae Month,6,327,93,420
3348,436510,Worlds of Chaos: Invasion,0,False,Tactichaos,0,5,2,7
3349,436520,Line of Sight,0,True,BlackSpot Entertainment,5,653,591,1244
3350,436530,Bullshot,0,False,GATO STUDIO,6,32,11,43
3351,436560,Kings and Heroes,0,False,Industry Games,5,282,263,545
3352,435970,RefRain - prism memories -,0,False,RebRank,7,37,1,38
3353,436000,Lovely Planet Arcade,0,False,quicktequila,6,40,14,54
3354,436060,Lolly Joe,0,False,Peter Valencia,0,5,1,6
3355,436070,Nadia Was Here,0,False,Jajaben Games,7,23,3,26
3356,436110,Medusa's Labyrinth,0,True,Guru Games,7,12,3,15
3357,436140,Empire of the Gods,0,False,Lonely Troops,6,11,4,15
3358,436160,The Panic Room. House of secrets,0,True,GameXP.com,0,2,2,4
3359,436180,Spacelords,16,True,MercurySteam,5,24,21,45
3360,436220,A-10 VR,0,False,Futuretown,8,111,8,119
3361,436230,Detached,0,False,Anshar Studios,5,112,55,167
3362,436240,Melancholy Republic,0,False,Cloud Runner Studios,5,11,5,16
3363,436260,Ultimate Arena FPS,0,False,Kenneth Caselli,4,5,8,13
3364,436270,Civil War: 1863,0,False,HexWar Games,5,13,7,20
3365,436280,Sudoku Quest,0,False,Harbinger Beard,5,8,7,15
3366,436290,Children of Zodiarcs,0,False,Cardboard Utopia,5,152,71,223
3367,435480,Trials of the Blood Dragon,0,False,Redlynx,5,73,43,116
3368,435490,Pierhead Arcade,0,False,Mechabit Ltd,8,185,18,203
3369,435530,The Final Station,0,False,DO MY BEST,6,1227,348,1575
3370,435600,"My Tower, My Home",0,True,Shoor Games,0,2,2,4
3371,435730,apartment: a separated place,0,False,The Elsewhere Company,0,4,0,4
3372,435780,VIOLET: Space Mission,0,False,Killer Lobster,0,0,2,2
3373,435790,10 Second Ninja X,0,False,Four Circle Interactive,7,45,3,48
3374,435800,Binaries,0,False,Ant Workshop Ltd,7,32,3,35
3375,435840,The Preposterous Awesomeness of Everything,0,False,Joe Richardson,7,39,1,40
3376,435080,Philia : the Sequel to Elansar,0,False,OrionSoft,0,1,0,1
3377,435100,2Dark,18,False,Gloomywood,5,42,20,62
3378,435120,Rusty Lake Hotel,0,False,Rusty Lake,8,951,79,1030
3379,435140,Rush for gold: Alaska,0,False,Rainbow Games,0,7,0,7
3380,435230,Medieval Playground,0,False,Americo Mateus Rodrigues,5,4,6,10
3381,435250,Deadhunt,0,False,REL Games,6,24,8,32
3382,435260,Planet Stronghold: Colonial Defense,0,False,Winter Wolves,6,15,5,20
3383,435300,We Know the Devil,0,False,Pillow Fight,8,497,34,531
3384,435360,Campus Notes - forget me not.,0,False,4th cluster,7,39,2,41
3385,435400,Hidden Folks,0,False,Adriaan de Jongh,9,2312,77,2389
3386,435420,Operation: Matriarchy,0,False,Madia Entertainment,5,18,10,28
3387,435460,NotCoD™,0,False,NotGames,7,41,2,43
3388,434660,Octahedron: Transfixed Edition,0,False,Demimonde,8,49,2,51
3389,434700,Forgotten Ball,0,False,littleGigantic,0,2,2,4
3390,434730,Half Dead,0,False,Room710Games,6,815,248,1063
3391,434740,Lichtspeer,0,False,Lichthund,6,55,15,70
3392,434750,Z-Exemplar,0,False,Suminell Studios,7,20,0,20
3393,434790,Planet 1138,0,False,Bionic Pony,0,1,4,5
3394,434800,The Great Escape,0,False,XiNFiNiTY Games,0,1,5,6
3395,434820,Brushwood Buddies,0,False,Steven Colling,7,23,3,26
3396,434860,Wanderjahr,0,False,Workyrie Game Studio,0,3,1,4
3397,434870,Megalo Polis,0,False,Black Sheep studio,0,2,1,3
3398,434880,Hieroglyphika,0,False,M. Hanka,5,38,21,59
3399,434890,Eight Mini Racers,0,False,David Mulder,6,12,5,17
3400,434920,Last Heroes 2,0,False,Warfare Studios,5,14,8,22
3401,434930,GiAnt,0,False,Wreck Tangle Games,5,5,7,12
3402,434960,Rolling Gauntlet,0,False,Aundre Rogers,0,0,1,1
3403,434970,That Dam Level redux,0,False,noiarc,0,1,1,2
3404,434980,Onion Force,0,False,Queen Bee Games,7,10,1,11
3405,435000,The Whisperer in Darkness,0,False,Nat Quayle Nelson,7,25,6,31
3406,435010,Krinkle Krusher,0,False,Ilusis Interactive Graphics,7,8,2,10
3407,435020,AFL Evolution,0,False,Wicked Witch,6,71,27,98
3408,435030,Lost Lands: Mahjong,0,True,FIVE-BN GAMES,7,32,2,34
3409,435040,Incredible Dracula: Chasing Love Collector's Edition,0,False,New Bridge Games,7,14,2,16
3410,435050,Glory Kingdom,0,False,Matthew Robinson,0,1,2,3
3411,435070,Elansar,0,False,OrionSoft,5,5,5,10
3412,434150,Dark Night,0,False,NighthoodGames,5,8,10,18
3413,434160,A Hole New World,0,False,MadGearGames,6,21,9,30
3414,434170,The Jackbox Party Pack 3,0,False,"Jackbox Games, Inc.",9,2596,71,2667
3415,434190,Follia - Dear father,0,False,Real Game Machine,6,29,11,40
3416,434220,Bear Haven Nights,0,False,SunRay Games,7,14,1,15
3417,434230,Fairies vs. Darklings: Arcane Edition,0,False,Interama - Interactive Technology,0,7,1,8
3418,434240,Alien Blitz,0,False,Jean-Baptiste Simillon,0,1,0,1
3419,434250,Masked Shooters 2,0,False,Freeze Nova,8,262,65,327
3420,434260,My Name is Mayo,0,False,Green Lava Studios,8,1045,215,1260
3421,434270,Parasite,0,False,Raphael Gervaise,0,2,3,5
3422,434290,Typefighters (Steam Edition),0,False,Christian Reuter,5,64,30,94
3423,434300,Wormhole City,0,True,Zenrok Studios,0,2,0,2
3424,434310,imprint-X,0,False,Morgondag,6,11,3,14
3425,434340,Spheria,0,False,Daydream Software,0,1,0,1
3426,434360,Kitten Rampage,0,False,Dexmes,4,13,23,36
3427,434370,Buried: An Interactive Story,0,False,Bromoco Games,8,127,6,133
3428,434390,Lost Bros,0,False,Wheat Muffin Games,0,5,0,5
3429,434410,Moonlight,0,False,Kevin Horton,8,98,4,102
3430,434420,The Chosen RPG,18,False,Little Big Lee,5,300,159,459
3431,434430,Abbot's Book Demo,0,True,"The Abbot's Book, LLC",0,4,1,5
3432,434470,Puzzle Party,0,False,Kris Patrick,0,6,1,7
3433,434480,Mathoria: It All Adds Up,0,True,Senshi.Labs,0,0,1,1
3434,434490,Otem's Defiance,0,False,HyperBerry Games,0,6,0,6
3435,434510,Formicide,0,True,"Rock Wall Games, LLC",0,8,0,8
3436,434530,Flobe,0,False,Skinny Jean Death Studios,7,13,1,14
3437,434540,Secret of the Pendulum,0,False,GamesCafe,0,0,1,1
3438,434570,Blood and Bacon,0,False,Big Corporation,9,9695,417,10112
3439,434600,Blue Bird,0,False,Deadline Soft,0,7,2,9
3440,434610,Forbidden Planet,0,False,Faton,4,12,22,34
3441,434620,Pythagoria,0,False,Vladimir Maslov,6,79,30,109
3442,433750,The Grandfather,0,True,Mikeypoo's Games,5,19,15,34
3443,433790,Wooden Floor 2 - Resurrection,0,False,pheenix93,0,4,5,9
3444,433830,Rescue From Goblin Deep,0,False,Duncan Perham,0,2,2,4
3445,433840,Trulon: The Shadow Engine,0,False,Kyy Games,4,5,10,15
3446,433850,Z1 Battle Royale,0,True,Daybreak Game Company,5,19807,19313,39120
3447,433890,MechoEcho,0,False,Resilient Games Ltd.,7,12,3,15
3448,433900,Helium,0,False,rocketship,5,14,13,27
3449,433910,Neon Drive,0,False,Fraoula,8,628,110,738
3450,433920,Aveyond 4: Shadow of the Mist,0,False,"Amaranth Games, LLC",8,52,6,58
3451,433930,MARI indie 3.0,0,False,The Foundry,4,5,8,13
3452,433950,Bit Blaster XL,0,False,Adamvision Studios,9,2892,81,2973
3453,433960,Shadow Of Nebula,0,False,Damian,0,3,1,4
3454,434000,Paws,0,False,Might and Delight,8,273,30,303
3455,434020,Last Hope - Tower Defense,0,False,JE Software,8,160,37,197
3456,434030,Aerofly FS 2 Flight Simulator,0,False,IPACS,6,817,219,1036
3457,434050,Duke Nukem 3D: 20th Anniversary World Tour,16,False,"Nerve Software, Gearbox Software, LLC",6,1158,300,1458
3458,434070,Plight of the Zombie,0,False,"Spark Plug Games, LLC",0,4,2,6
3459,434090,Bridge! 2,0,False,toxtronyx interactive GmbH,4,5,14,19
3460,434130,Witch and Hero(魔女と勇者),0,False,FK Digital,0,8,1,9
3461,434140,New Outbreak,0,False,0Bennyman,0,1,1,2
3462,433350,BlackShot: Mercenary Warfare FPS,0,True,Vertigo Games America,5,9,7,16
3463,433360,Drawn™: Dark Flight,0,False,Big Fish Studios,0,4,4,8
3464,433380,Back in 1995,0,False,Throw the warped code out,6,39,16,55
3465,433400,Kim,0,False,The Secret Games Company,6,17,6,23
3466,433450,INFERNO CLIMBER,0,False,Arc System Works,5,28,15,43
3467,433480,Rayon Riddles - Rise of the Goblin King,0,False,Lost The Game Studios,0,4,0,4
3468,433490,Super Flippin' Phones,0,False,BlauwPrint,7,10,1,11
3469,433530,Heliborne Collection,0,False,Klabater,6,1258,392,1650
3470,433550,DARQ: Complete Edition,0,False,Unfold Games,8,1218,73,1291
3471,433570,Side Quest,0,False,Miris Mind,0,1,3,4
3472,433580,Timelapse,0,False,GTE Entertainment,7,20,3,23
3473,433630,vrAMP,0,False,Oriku Inc,6,27,10,37
3474,433650,Book Of Merlin,0,False,乐客游戏,5,6,9,15
3475,433660,Blockpocalypse,0,False,dimeStudios,0,4,0,4
3476,433670,Professional Farmer 2017,0,False,VIS-Games,3,1,24,25
3477,433700,Carpe Lucem - Seize The Light VR,0,False,Hammer Labs,7,21,3,24
3478,432870,Special Tactics,0,True,Beast Mode Games,6,25,7,32
3479,432890,Quote,0,False,Vindit,0,8,1,9
3480,432940,Breakneck,0,False,PikPok,6,51,17,68
3481,432950,Orange Moon,0,False,Betelgeuse Zero,7,13,3,16
3482,432980,INVERSUS Deluxe,0,False,Hypersect,8,89,7,96
3483,432990,Green Game: TimeSwapper,0,False,iFun4all S.A.,0,4,0,4
3484,433000,Lost Lands: The Golden Curse,0,False,FIVE-BN GAMES,8,231,16,247
3485,433100,The Town of Light,0,False,LKA,6,463,176,639
3486,433110,Zipple World,0,False,Alternative Dreams,5,6,5,11
3487,433120,Crash Landing,0,False,Claws of Lorek,0,2,4,6
3488,433130,WarBirds Dogfights,0,False,iEntertainment Network Inc,0,1,5,6
3489,433170,Die Young,0,False,IndieGala,6,392,110,502
3490,433190,CDF Starfighter VR,0,False,MAG Studios,5,48,27,75
3491,433210,Rhino's Rage,0,False,Defroids,0,1,0,1
3492,433280,Warlords Battlecry III,0,False,Infinite Interactive,6,241,71,312
3493,433300,Marvel: Ultimate Alliance,0,False,Zoë Mode,5,204,164,368
3494,433320,Marvel: Ultimate Alliance 2,0,False,Zoë Mode,5,106,140,246
3495,433340,Slime Rancher,0,False,Monomi Park,9,35482,758,36240
3496,432370,Sethian,0,False,"Duang! Games, LLC",6,42,15,57
3497,432380,Hydra Slayer,0,False,Zeno Rogue,7,24,2,26
3498,432390,Weekend Drive,0,False,GTGD,0,1,0,1
3499,432410,The Sacred Stone,0,False,Panzer Gaming,0,1,5,6
3500,432420,Ludoria,0,False,Eminent Softworks,0,4,5,9
3501,432470,Magdalena,0,False,MagdalenaTeam,4,14,42,56
3502,432480,Grenade Madness,0,False,Touch Orchestra,0,1,1,2
3503,432490,ATOM GRRRL!!,0,False,Cosmillica,5,8,4,12
3504,432500,Evertown,0,False,cg-imagine,4,15,25,40
3505,432590,And So It Was,0,False,VolumeUp Studios,4,7,13,20
3506,432620,Mimic Arena,0,False,Tiny Horse Games,0,3,0,3
3507,432640,BuriedTown,0,False,Dice7,0,3,6,9
3508,432720,Welkin Road,0,False,Gregor Panič,5,13,7,20
3509,432770,Small Town Terrors: Livingston,0,False,Gunnar Games,0,8,1,9
3510,432780,Dream Catcher Chronicles: Manitou,0,False,Viva Media,5,6,6,12
3511,432790,Angel Flare,0,False,Kuchnier Games,0,0,1,1
3512,431810,Rencounter,0,False,SPVD,5,46,27,73
3513,431830,Drift Into Eternity,0,False,We Are Bots,0,7,2,9
3514,431840,3DRPG,0,False,Doomster Entertainment,5,44,19,63
3515,431850,Projector Face,0,False,Fluik Entertainment Inc,6,22,7,29
3516,431910,Psychocat: The Answer,0,False,Chewa,8,62,13,75
3517,431930,Kabounce,0,False,Stitch Heads Entertainment,8,91,8,99
3518,431940,Wildfire,0,False,Sneaky Bastards,8,109,21,130
3519,432010,World's Dawn,0,False,Wayward Prophet,8,459,108,567
3520,432030,Swanky Paint,0,False,Wetgenes,0,4,1,5
3521,432100,Negligee,0,False,Dharker Studio,8,337,63,400
3522,432110,Echo Tokyo: Phoenix,0,False,Echo Games,4,5,8,13
3523,432130,Break Chance Memento,0,False,Cyanide Tea,7,19,4,23
3524,432170,Silver Knight,0,False,Wojciech Krupinski,5,9,8,17
3525,432180,Discouraged Workers TEEN,0,False,YGGDRASIL STUDIO,5,9,7,16
3526,432190,Chef Solitaire: USA,0,False,The Revills Games,8,60,5,65
3527,432210,The Revenant Prince,0,False,Nomina Games,0,5,3,8
3528,432230,"Axe, Bow & Staff",0,False,Clewcat Games,0,2,3,5
3529,432240,UnderDread,0,False,Bigzur Games,5,10,15,25
3530,432250,Soviet City,0,False,chickeninthecornstudio,5,42,19,61
3531,432260,Tiltagon,0,False,Kiemura Ltd,6,15,5,20
3532,432270,No Seat?,0,False,khos85,0,1,4,5
3533,432330,Rytmik Lite Chiptune Synthesizer,0,False,"CINEMAX, s.r.o.",5,33,16,49
3534,432350,Epic Battle Fantasy 5,0,False,Matt Roszak,9,1779,18,1797
3535,431330,Dungeons Are Random,0,False,PIXELBUG,0,2,5,7
3536,431360,The Legend: A University Story,0,False,Austin Handle,0,2,3,5
3537,431370,Diorama No.3 : The Marchland,0,False,The Shoebox Diorama (Daniel Ernst),7,8,2,10
3538,431410,Mazement,0,False,Wronghut,0,5,2,7
3539,431450,Alchemist's Awakening,0,False,Osaris Games,6,124,49,173
3540,431460,Midnight,0,False,Petite Games,5,20,11,31
3541,431470,Inside The Code,0,False,Tinycorp,0,0,1,1
3542,431500,Clash of the Monsters,0,True,Cadence Games,0,5,1,6
3543,431510,Mystic Destinies: Serendipity of Aeons,0,True,Aeon Dream Studios,5,9,4,13
3544,431540,Frosty Kiss,0,True,2Chance Projects,7,14,3,17
3545,431570,Breakroom,0,False,MURE VR,0,1,4,5
3546,431590,Earn to Die 2,0,False,Toffee Games,8,146,17,163
3547,431600,Automobilista,0,False,Reiza Studios,8,451,77,528
3548,431610,Hubert's Island Adventure: Mouse o' War,0,False,Cheese and Bacon Games,0,2,1,3
3549,431630,Action Legion,0,False,Aeonic Entertainment,6,11,3,14
3550,431640,Doodle Kingdom,0,False,JoyBits Ltd.,4,14,29,43
3551,431650,Phoning Home,0,False,ION LANDS,5,192,98,290
3552,431700,Age of Fear 3: The Legend,0,False,Leslaw Sliwko,8,102,4,106
3553,431710,Space Pilgrim Episode II: Epsilon Indi,0,False,Pilgrim Adventures,8,164,20,184
3554,431730,Aseprite,0,False,David Capello,9,3478,18,3496
3555,431740,Chowderchu,0,False,Ryan Jensen,0,1,1,2
3556,431750,Iron Sea Defenders,0,False,Creobit,6,69,19,88
3557,431770,Rivalry,0,False,Kew McParlane,8,117,10,127
3558,430930,Z. Year One,0,False,Downward Viral,5,10,5,15
3559,430960,Lucy -The Eternity She Wished For-,0,False,Modern Visual Arts Laboratory,8,1214,69,1283
3560,431030,The Music Room,0,False,Chroma Coda,0,0,1,1
3561,431120,Tethered,0,False,Secret Sorcery Limited,8,112,18,130
3562,431180,WolfQuest: Classic,0,False,eduweb,8,934,86,1020
3563,431200,Disastr_Blastr,0,False,Dog Theory,7,11,1,12
3564,431220,Porradaria 2: Pagode of the Night,0,False,CleanWaterSoft,0,7,0,7
3565,431230,Tiny Guardians,0,False,Kurechii,7,33,5,38
3566,431250,Mushroom Wars,0,False,Zillion Whales,8,101,25,126
3567,431280,tiny & Tall: Gleipnir,0,False,tT Studios,7,24,1,25
3568,431290,Level 22: Gary’s Misadventures - 2016 Edition,0,False,Moving Player,0,4,2,6
3569,431300,Classic Fun Collection 5 in 1,0,False,3DDUO,0,2,1,3
3570,430410,Memoranda,0,False,Bit Byterz,6,36,15,51
3571,430020,Dance of Death,12,False,eight game studio,5,60,46,106
3572,430080,Elysium: Blood Games,0,False,SimProse Studios,5,15,13,28
3573,430100,darkcase : the basement,0,False,TrerPlay,0,6,1,7
3574,430170,Babel: Choice,0,False,Sogoal,0,0,2,2
3575,430190,Wondershot,0,False,Leikir Studio,0,1,0,1
3576,430210,Megaton Rainfall,0,False,"Pentadimensional Games, SL",6,676,247,923
3577,430230,Grass Max,0,False,AAAGAMES,0,6,1,7
3578,430240,Duplexer,0,False,Vantage Games,0,3,4,7
3579,430280,Nature Defenders,0,False,Nordic Mist Games,0,0,2,2
3580,430290,Shmups Skill Test シューティング技能検定,0,False,TRIANGLE SERVICE,7,17,2,19
3581,430300,MINUS ZERO,0,False,TRIANGLE SERVICE,0,5,2,7
3582,429600,Fairy Tale Mysteries: The Puppet Thief,0,False,The House of Fables,6,38,13,51
3583,429610,The Emerald Maiden: Symphony of Dreams,0,False,Gogii Games,8,73,17,90
3584,429620,Dungeon Rushers,0,False,Goblinz Studio,5,123,96,219
3585,429660,Tales of Berseria™,0,False,BANDAI NAMCO Studios Inc.,8,4284,344,4628
3586,429690,Astro Duel,0,False,Rusty Moyher,7,39,1,40
3587,429700,Squirbs,0,False,Team Indev,5,67,51,118
3588,429720,IMSCARED,0,False,Ivan Zanotti's MyMadnessWorks,8,595,48,643
3589,429780,Bunny Hop League,0,False,PolyDigital,6,198,81,279
3590,429790,AdventureQuest 3D,0,True,"Artix Entertainment, LLC",6,39,12,51
3591,429830,Unseen Diplomacy,0,False,Triangular Pixels,8,124,15,139
3592,429940,The Sad Story of Emmeline Burns,0,True,ebi-hime,7,13,2,15
3593,429950,ABO MANDO,0,False,UNDEAD,0,0,1,1
3594,429060,Zombie Wars: Invasion,0,False,DNZY Games,4,7,18,25
3595,429160,Cyborg Rage,0,True,Ragiva Games,0,0,2,2
3596,429180,Project CARS - Pagani Edition,0,True,Slightly Mad Studios,4,4,11,15
3597,429220,FullBlast,0,False,UFO Crash Games,5,13,8,21
3598,429250,Beyond Dimensions,0,False,Cool Frogs Studio,0,2,0,2
3599,429260,Super Intergalactic Gang,0,False,Martin Cerdeira,0,6,0,6
3600,429270,Didgery,0,False,Lotus Games,0,3,0,3
3601,429280,Gems of the Aztecs,0,False,Wellore,5,13,7,20
3602,429300,Sepia Tears,0,True,Scarlet String Studios,7,15,0,15
3603,429330,Stikbold! A Dodgeball Adventure,0,False,Game Swing,8,80,8,88
3604,429350,Satellite Rush,0,False,Kimeric Labs,0,8,1,9
3605,429360,Lupinball,0,False,Craftven,7,36,1,37
3606,429390,XenoShyft,0,False,Cool Mini or Not,5,44,22,66
3607,429430,Tyrfing  Cycle |Vanilla|,0,False,Demon Sword Games,0,2,1,3
3608,429470,Space Pilgrim Episode I: Alpha Centauri,0,True,Pilgrim Adventures,8,394,28,422
3609,429480,Vision Runner,0,False,Snowbit Interactive,0,0,1,1
3610,429490,Resilience Wave Survival,0,False,Jimbob Games,5,64,37,101
3611,429520,Falcon Gold,0,False,Spectrum Holobyte,0,4,1,5
3612,429530,Falcon 4.0,0,False,Microprose,6,58,16,74
3613,429570,The Walking Dead: Michonne - A Telltale Miniseries,18,False,Telltale Games,6,1371,461,1832
3614,429580,A Wild Catgirl Appears!,0,False,NewWestGames,5,39,23,62
3615,428610,Longsword - Tabletop Tactics,0,True,Zero Sum Games,5,31,15,46
3616,428630,White Mirror,0,False,GDNomad,4,22,50,72
3617,428660,Deliver Us The Moon,0,False,KeokeN Interactive,8,1300,197,1497
3618,428690,Youtubers Life,0,False,UPLAY Online,6,4748,1545,6293
3619,428740,Nordenfelt,0,False,Black Golem,0,1,2,3
3620,428750,Neon Chrome,0,False,10tons Ltd,8,344,15,359
3621,428760,Hatch and Slay,0,False,Myrolit Studios,0,4,3,7
3622,428800,liteCam Game 5:  120 FPS Game Capture + Streamer,0,False,Rsupport Inc.,4,16,37,53
3623,428830,Save the Dodos,0,False,3DDUO,7,41,2,43
3624,428860,Red Haze,0,False,Yai Gameworks,8,103,18,121
3625,428870,Take the Dream IX,0,True,Yai Gameworks,0,4,1,5
3626,428880,The Quest,0,False,Redshift,8,255,36,291
3627,428900,"Linea, the Game",0,False,KHB-Soft,8,258,56,314
3628,428910,Red Fox and the Four Seasons,0,False,Boogygames Studios,0,1,1,2
3629,428920,WinKings,0,False,Lemondo Games,0,3,1,4
3630,428930,Into the Belly of the Beast,0,False,Lucky Brograms,0,1,0,1
3631,428940,CONTASION 2,0,False,Alex Woodcock,0,0,2,2
3632,428950,"Kivi, Toilet and Shotgun",0,False,16bit Nights,5,38,43,81
3633,428980,Ethereal Legends,0,False,Soverance Studios,0,2,4,6
3634,429020,LONE WOLF: Horizon,0,False,m4g,4,7,15,22
3635,429040,Furfly,0,False,SMD Gaming Studio,0,6,3,9
3636,428200,Attack Heroes,0,False,Ejoy Games,6,17,7,24
3637,428210,Horror in the Asylum,0,False,Adham Jaber,4,7,12,19
3638,428220,TurnOn,0,False,Brainy Studio LLC,6,38,16,54
3639,428230,Swift,0,False,Windflow,0,2,1,3
3640,428240,Hauntsters,0,False,Shark Tree Studios,0,2,0,2
3641,428250,Mystery Castle: The Mirror's Secret,0,False,Meridian'93,5,4,6,10
3642,428260,The Book of Desires,0,False,Meridian'93,0,4,4,8
3643,428270,Twilight City: Love as a Cure,0,False,Meridian'93,0,5,4,9
3644,428280,Mystery of Unicorn Castle: The Beastmaster,0,False,Meridian'93,7,17,1,18
3645,428340,Marmoset Hexels 3,0,False,Marmoset LLC,8,109,12,121
3646,428350,Fear Equation,0,False,Screwfly Studios,6,38,11,49
3647,428370,Windlands,0,False,Psytec Games Ltd,6,517,155,672
3648,428410,PRiO,0,False,DanielDavisGames,0,3,2,5
3649,428430,Endorlight,0,False,Unika Games,5,19,17,36
3650,428460,Kings of Israel,0,False,Alastair John Jack,8,47,7,54
3651,428490,Germination,0,False,Sullivan Boyd & Cadence Petersen,6,10,3,13
3652,428510,Solitaire Christmas. Match 2 Cards,0,False,Creobit,5,11,6,17
3653,428530,Machine Gun Train Run,0,False,Party Robot Studio,0,7,1,8
3654,428540,Fragments of Him,0,False,Sassybot,8,54,13,67
3655,428590,Unearthing Colossal,0,False,Power Up to Maximum,0,0,3,3
3656,427700,Zwei: The Ilvard Insurrection,0,False,Nihon Falcom,8,99,6,105
3657,427730,Who's Your Daddy?!,0,False,Evil Tortilla Games,6,7792,2281,10073
3658,427760,A Chair in a Room : Greenwater,0,False,Wolf & Wood Interactive Ltd,8,417,78,495
3659,427770,Pills4Skills,0,False,Petro Shoferystov,0,7,1,8
3660,427780,PERFECT ANGLE: The puzzle game based on optical illusions,0,False,Ivanovich Games,5,8,10,18
3661,427810,CALENDULA,0,False,Blooming Buds Studio,5,124,57,181
3662,427820,Hitman GO: Definitive Edition,7,False,Square Enix Montréal,8,578,97,675
3663,427830,Hybrid Beasts,0,False,Beastbits,0,0,1,1
3664,427860,The Next World,0,False,Illuminated Games,5,47,22,69
3665,427880,P.A.M.E.L.A.®,0,False,NVYVE® Studios,5,371,215,586
3666,427890,Felt Tip Circus,0,False,Alpha Wave Entertainment,7,14,2,16
3667,427910,Zavix Tower,0,False,Batholith Entertainment,5,90,47,137
3668,427930,Army of Tentacles: (Not) A Cthulhu Dating Sim,0,False,Stegalosaurus Game Development,5,13,9,22
3669,427970,Heathen Engineering's Terran,0,False,Heathen Engineering,0,1,4,5
3670,427980,Aozora Meikyuu,18,False,Yume Creations,8,119,29,148
3671,428020,The ORPHEUS Ruse,0,False,Choice of Games,0,5,2,7
3672,428040,Sixth Grade Detective,0,False,Choice of Games,7,26,2,28
3673,428060,Millia -The ending-,0,True,Millia Soft,0,9,0,9
3674,428080,Racket: Nx,0,False,One Hamsa,8,314,10,324
3675,428100,Beyond Reality,0,False,EternalShadow Studios,8,42,9,51
3676,428110,Save Halloween: City of Witches,0,False,Quick Click Games,6,7,3,10
3677,428130,Walk The Light,0,False,Anti Crunch Studios,0,3,0,3
3678,428170,Little Reaper,0,False,Little Reaper Games,7,9,2,11
3679,428180,Islet Online,0,False,Morenori Soft,5,34,19,53
3680,428190,MadOut Open City,0,False,MadOut Games,4,23,67,90
3681,427470,Democracy 3 Africa,0,False,Positech Games,6,200,65,265
3682,427480,FritzChess 15,0,False,ChessBase GmbH,5,16,15,31
3683,427490,Shadowhand: RPG Card Game,0,False,Grey Alien Games,8,376,75,451
3684,427510,Way of the Samurai 3,0,False,ACQUIRE Corp.,6,207,54,261
3685,427550,Tibetan Quest: Beyond the World's End,0,False,Brave Giant LTD,5,22,11,33
3686,427570,Dawn of Andromeda,0,False,Grey Wolf Entertainment,5,58,52,110
3687,427640,The Ables: Freepoint High,0,False,"Qiwi Games, LLC",6,10,4,14
3688,427660,NightCry,0,False,Nude Maker,5,71,31,102
3689,427030,Xuan-Yuan Sword: The Gate of Firmament,0,False,DOMO Studio,8,132,22,154
3690,427040,Pitstop Challenge,0,False,Laudo Games,0,0,5,5
3691,427050,Siege - the card game,0,False,SIA Next Level,0,3,3,6
3692,427190,DEAD RISING®,0,False,Capcom,8,1790,152,1942
3693,427240,Cosmic Trip,0,False,Funktronic Labs,8,294,37,331
3694,427250,8-Bit Armies,0,False,Petroglyph,6,831,214,1045
3695,427270,Orcs Must Die! Unchained,0,False,Robot Entertainment,5,62,37,99
3696,427290,Vampyr,0,False,DONTNOD Entertainment,6,4071,1382,5453
3697,426560,Full Tilt Poker,18,False,Rational Social Projects Limited,0,1,0,1
3698,426590,Blood of Magic,0,False,Stoneworks Games,3,6,34,40
3699,426630,Bubsy Two-Fur,0,False,Accolade,6,180,65,245
3700,426690,Narcissu 10th Anniversary Anthology Project,0,False,stage-nana,8,81,4,85
3701,426790,Grow Up,0,False,"Reflections, a Ubisoft Studio",8,845,85,930
3702,426930,Moonshot,0,False,Pump Action Games,6,24,7,31
3703,426170,Defragmented,0,False,Glass Knuckle Games,5,12,7,19
3704,426190,Miner Meltdown,0,False,Mighty Pebble Games Inc,6,32,12,44
3705,426210,Tyran,0,False,Dragon's Games,5,7,8,15
3706,426240,Caretaker Sacrifice,0,False,Xiotex Studios Ltd,7,10,1,11
3707,426290,The Away Team: Lost Exodus,0,False,Underflow Studios,6,32,9,41
3708,426310,Perception,0,False,The Deep End Games,6,128,52,180
3709,426330,MetaHuman Inc.,0,False,Choice of Games,8,117,12,129
3710,425720,Cloudlands : VR Minigolf,0,False,Futuretown,8,222,42,264
3711,425760,EGO Protocol,0,False,Static Dreams,0,2,1,3
3712,425770,Answer The Question,0,False,Penny McDonald,8,106,1,107
3713,425860,Vector Assault,0,False,WizByte Games,0,3,2,5
3714,425870,Gyrodisc Super League,0,False,Valiant Interactive,0,0,2,2
3715,425900,Adventure Lamp,0,False,Ryan Davis,0,5,2,7
3716,425990,Space Junk Patrol,0,False,Anthracite Games,0,2,0,2
3717,426000,HunieCam Studio,18,False,HuniePot,8,2796,418,3214
3718,426010,Womb Room,0,False,Bearded Eye,4,11,23,34
3719,426040,Goodnight Butcher,0,False,Perfect Square Studios,5,7,4,11
3720,426050,LEGIE,0,False,Spytihněv,7,24,1,25
3721,425220,One Piece Burning Blood,0,False,"Spike Chunsoft Co., Ltd.",6,394,107,501
3722,425230,Sword 'N' Board,0,False,Stuffed Castle Studios,0,3,1,4
3723,425240,Pressure Overdrive,0,False,Chasing Carrots,5,19,14,33
3724,425260,Soul Harvest,0,False,Nanoleptic Games,0,4,2,6
3725,425300,Super Button Soccer,0,False,LIGA - Laboratório de Inovação de Games e Apps,0,0,6,6
3726,425310,Ghostbusters™,0,False,FireForge Games,4,5,8,13
3727,425340,Space Moth DX,0,False,1CC Games,8,54,7,61
3728,425400,Block Rocking Beats,0,False,Sander Sneek,0,2,3,5
3729,425410,Road to Ballhalla,0,False,Torched Hill,7,18,1,19
3730,425450,GoatPunks,0,False,Alberto Santiago,6,8,3,11
3731,425460,Tokyo Twilight Ghost Hunters Daybreak: Special Gigs,0,False,Arc System Works,5,18,8,26
3732,425580,The Room Two,0,False,Fireproof Games,9,6245,147,6392
3733,425600,The Order of the Thorne - The King's Challenge,0,False,Infamous Quests,8,61,10,71
3734,425650,Halloween Forever,0,False,Imaginary Monsters,8,108,7,115
3735,425670,Seraph,0,False,Dreadbit,8,207,44,251
3736,424750,The BoX,0,False,White Clover Worlds,0,4,0,4
3737,424760,Bladestar,0,False,"Fair Weather Studios, LLC",5,16,12,28
3738,424830,Bell Ringer,0,False,Night Node Software,0,1,1,2
3739,424840,Little Nightmares,0,False,Tarsier Studios,8,9999,729,10728
3740,424850,Galactineers,0,False,LInsoDeTeh,0,1,5,6
3741,424870,Threads of Destiny,0,False,Warfare Studios,0,6,2,8
3742,425010,ScudBuster,0,False,HyperKat Games,0,2,1,3
3743,425040,ComixPlay #1: The Endless Incident,0,False,ComixPlay,7,10,0,10
3744,425070,Asteroids Minesweeper,0,False,Francois Braud (Volatile Dove),7,33,7,40
3745,425150,Assassins vs Pirates,0,False,DEADBIT,5,7,9,16
3746,425160,Recursion Deluxe,0,False,2D Heroes,7,18,3,21
3747,425210,Shadwen,0,False,Frozenbyte,6,373,98,471
3748,424250,Balrum,0,False,Balcony Softworks,6,232,74,306
3749,424260,Feelings Adrift,0,False,Denis Murias,5,6,8,14
3750,424280,Iron Snout,0,True,SnoutUp,8,101,3,104
3751,424320,Anomaly 1729,0,False,"Anvil Drop, LLC",0,5,1,6
3752,424590,Farm Expert 2017,0,False,Silden,5,60,73,133
3753,424640,Karaski: What Goes Up...,0,False,Unbound Creations,7,10,2,12
3754,423800,Automata Empire,0,False,Nonadecimal Creative,5,24,13,37
3755,423810,Marooners,0,False,M2H,5,43,37,80
3756,423870,Astervoid 2000,0,False,Mad Capacity,7,13,3,16
3757,423880,Carpe Diem,0,True,Moonlit Works,7,27,3,30
3758,423890,Gods and Idols,0,True,Viking Tao,5,11,8,19
3759,423900,Dinocide,0,False,AtomicTorch Studio,5,12,7,19
3760,423950,Deadlight: Director's Cut,18,False,Tequila Works,5,99,62,161
3761,424000,Project Pulsation,0,False,VGstudio,3,1,13,14
3762,424010,Crudelis,0,False,Whiskey Jack Games,0,6,2,8
3763,424030,War of Rights,0,False,Campfire Games,8,3785,632,4417
3764,424040,Fragmental,0,False,Ruffian Games,7,12,3,15
3765,424060,The Glow,0,False,Brainwashing games,4,3,9,12
3766,424100,Celestrion,0,False,"dSky9, Inc.",0,4,0,4
3767,424170,The fall of gods,0,False,GeexGames,6,19,7,26
3768,423440,Choice of Kung Fu,0,False,Choice of Games,7,38,1,39
3769,423490,Air Missions: HIND,0,False,3Division,8,175,43,218
3770,423550,Day D: Tower Rush,0,False,Creobit,6,30,11,41
3771,423580,Project Highrise,0,False,SomaSim,8,1336,246,1582
3772,423590,The Little Acre,0,False,Pewter Games Studios,8,172,35,207
3773,423600,Adelantado Trilogy. Book one,0,False,Whiterra,7,11,2,13
3774,423610,Where's My Mommy?,13,False,Exquisite Games,6,32,13,45
3775,423620,HERO DEFENSE,0,False,Happy Tuesday,5,143,65,208
3776,423650,Summer Fling,0,False,Dharker Studio,5,23,17,40
3777,423700,Apocalypse Hotel - The Post-Apocalyptic Hotel Simulator!,0,False,Michael Flynn,4,7,27,34
3778,423710,Invasion: Brain Craving,0,False,New Reality Games,5,40,55,95
3779,423720,Color Chaos,0,False,Daniel Riley,0,1,1,2
3780,423730,Hyper Gods,0,False,Ground Control Studios,0,3,1,4
3781,423740,Save Your Mother,0,False,Tuomo Laine,5,11,10,21
3782,423750,Gardenarium,0,False,Paloma Dawkins,6,15,6,21
3783,423760,Hit Tank PRO,0,False,Bacq Stellan,0,2,2,4
3784,423770,Our Love Will Grow,0,False,John Wizard,6,58,18,76
3785,423120,Community College Hero: Trial by Fire,0,False,Hosted Games,8,183,29,212
3786,423180,A.I. Space Corps,0,False,GameArt Studio GmbH,0,0,3,3
3787,423220,T-Kara Puzzles,0,False,Mexond,0,5,0,5
3788,423230,Furi,0,False,The Game Bakers,8,3948,324,4272
3789,423320,Pendragon Rising,0,False,Choice of Games,8,65,14,79
3790,422910,Creeper World: Anniversary Edition,0,False,Knuckle Cracker,8,337,10,347
3791,422920,Creeper World 2: Anniversary Edition,0,False,Knuckle Cracker,8,158,19,177
3792,422940,Divergence: Online,0,False,Stained Glass Llama,5,46,37,83
3793,422970,Devil Daggers,0,False,Sorath,9,3867,140,4007
3794,422980,Super Robot Jump Jump,0,False,Beyond Technical Inc.,5,6,4,10
3795,422500,Emmerholt: Prologue,0,True,Oneiric Entertainment LLC,6,27,9,36
3796,422610,1775: Rebellion,0,False,HexWar Games,6,20,8,28
3797,422640,VR Karts SteamVR,0,False,Viewpoint Games,4,13,22,35
3798,422650,Megamagic: Wizards of the Neon Age,0,False,BeautiFun Games,5,8,9,17
3799,422760,Ocean Rift,0,False,Llyr ap Cenydd,6,58,16,74
3800,422810,River City Ransom: Underground,0,False,Conatus Creative Inc.,6,703,259,962
3801,422860,Holodance,0,False,narayana games UG,8,142,20,162
3802,422010,Eczema Angel Orifice,0,False,Porpentine,0,3,0,3
3803,422020,Dark Days,0,False,Brutal Studio,5,18,8,26
3804,422030,ReVeN: XBridge,0,False,Varia Games,0,3,3,6
3805,422110,Wand Wars,0,False,Moonradish Inc.,8,108,5,113
3806,422130,Comic Book Hero: The Greatest Cape,0,False,Grey Dog Software,5,21,29,50
3807,422140,Wrestling Spirit 3,0,False,Grey Dog Software,5,6,9,15
3808,1152550,Who Is You,0,False,RepSolo,0,1,0,1
3809,1151390,Putin Life,0,False,PutinDevTeam,7,37,2,39
3810,1150480,Micro Car Crash Online Le Go!,0,False,Smartmove,0,2,0,2
3811,1149900,Cheer and Track,0,False,David T. Potter,0,0,1,1
3812,1149910,Binky show,0,False,Ignite studio,0,1,0,1
3813,1149400,The Yellow King,0,False,Spellbook,5,87,58,145
3814,1148810,Tip of the Spear: Task Force Elite,0,False,"Red Jake Studios, LLC",8,118,15,133
3815,1147280,Column on the Sea,0,False,Griffin Snow,0,4,0,4
3816,1147490,Frontline: Western Front,0,False,Frontline: Games Series,7,18,3,21
3817,1147500,A Gay's Life,0,False,橙光游戏,7,26,2,28
3818,1147510,Hentai Asmodeus,0,False,HEGA Studio,8,385,53,438
3819,1147520,Super Bora Dragon Eyes,0,False,celikgames,0,0,1,1
3820,1147600,Star Police,0,False,Small Games,0,3,0,3
3821,1147620,The Lost Dungeon Of Knight,0,False,Axe Games,0,0,1,1
3822,1147670,Hentai Fetish Tycoon,0,False,Retisi,6,35,15,50
3823,1146880,RRRR3,0,False,Dnovel,0,6,0,6
3824,1146890,MMX,0,False,Dnovel,0,2,0,2
3825,1146910,Atomorf2,0,False,Dnovel,0,3,0,3
3826,1146920,Xenociders,0,False,Donuts Co. Ltd.,0,3,3,6
3827,1146940,I will eat you,0,False,Butengo,6,78,24,102
3828,1146950,Hentai Girl Fantasy,0,False,GirlGame,9,526,23,549
3829,1146970,My Vow to My Liege,0,False,YETU GAME,8,111,6,117
3830,1147020,Quest for Conquest,0,False,Pixel Pinecone,0,1,1,2
3831,1147030,The Terrible Old Man,0,True,Cloak and Dagger Games,0,3,2,5
3832,1147130,Countryballs: Modern Ballfare,0,False,Mildly Professional,7,34,0,34
3833,1147140,Funny Road Chase Simulator,0,False,Polantronic,0,0,1,1
3834,1147220,Grim Tales: Guest From The Future Collector's Edition,0,False,Elephant Games,0,2,0,2
3835,1147240,Rogue Waves,0,False,Diego Rodrigues,0,2,1,3
3836,1146390,Where Are We Now,0,False,The Prime Movers,0,1,0,1
3837,1146510,Deep Sleep Trilogy,0,False,scriptwelder,8,102,1,103
3838,1146560,Drawn Down Abyss,0,False,DaFluffyPotato,0,4,0,4
3839,1146630,Yokai's Secret,0,False,Double W,8,437,30,467
3840,1146700,Battle Sorcerers,0,False,G1 Playground,0,2,3,5
3841,1146780,Monster planet,0,False,Jinx,0,1,0,1
3842,1146810,Phantom Astronaut Lucid VR,0,False,Phantom Astronaut,0,1,1,2
3843,1145960,The White Door,0,False,Rusty Lake,8,758,90,848
3844,1145970,Forest Home,0,False,The Binary Mill,0,8,0,8
3845,1146010,Art of Boxing,0,False,Gold From Straw Games,5,17,20,37
3846,1146090,Flint,0,False,Splendortek,0,3,1,4
3847,1146100,The Rising of the Shield Hero : Relive The Animation,0,False,KADOKAWA CORPORATION,6,55,19,74
3848,1146160,The Tomb of Argazfell,0,False,Torvelt,0,1,0,1
3849,1146170,KingSim,0,False,Fuzzy Pixel Game Studio,8,41,9,50
3850,1146230,DungeonTop,0,False,One Up Plus Entertainment,8,126,14,140
3851,1146250,Seasons Girls,0,False,Decra,0,1,1,2
3852,1146300,Land of War - The Beginning,0,False,MS GAMES,5,39,41,80
3853,1146310,Beyond a Steel Sky,0,False,Revolution Software Ltd,8,378,60,438
3854,1146350,Urban riots,0,False,kiki,0,0,1,1
3855,1146370,Master of Magic Classic,0,False,SimTex,8,280,7,287
3856,1145490,Operation Armstrong,0,False,Fullbeans Studio,0,6,0,6
3857,1145520,Wall Force,0,True,Miha Prezelj,0,2,0,2
3858,1145530,One day,0,False,Zhongce Games,0,3,0,3
3859,1145550,守护传说 Guardian Legend,0,False,SL,0,0,1,1
3860,1145560,Marble Trap,0,False,NanningsGames,7,16,2,18
3861,1145570,Ortharion project,0,False,Ortharion project,6,36,14,50
3862,1145580,Wolves Team,0,False,SFVR,0,0,1,1
3863,1145590,Kastle Krush,0,False,Neiroanalitika,0,0,2,2
3864,1145660,Drift Of The Hill,0,False,RewindApp,6,232,72,304
3865,1145680,Pew-Pew Rocket,0,False,StarSystemStudios,0,2,0,2
3866,1145780,Angry Golf,0,False,Tero Lunkka,6,7,3,10
3867,1145810,Desert lost,0,False,JoJo,0,6,2,8
3868,1145820,INFECTIS,0,False,Aegon Games Ltd,0,3,2,5
3869,1145830,Clarevoyance,0,False,Fring Frang Games,0,2,0,2
3870,1145860,Quantum Multiverse,0,False,RipTyde Games,0,0,1,1
3871,1145950,Vector Prospector,0,False,SpinAttack Studio,0,8,1,9
3872,1145030,ef - the latter tale. (All Ages),0,False,minori,0,7,1,8
3873,1145050,Tonetaker VR,0,False,Daniel Rychlý,0,1,0,1
3874,1145120,Last Summer,0,False,murase,0,1,0,1
3875,1145180,uznali ? soglasnbI ?,0,False,lastgame,0,1,1,2
3876,1145200,Tomb Typing,0,False,Individual Software,0,1,0,1
3877,1145210,Typing with Sharks,0,False,Individual Software,0,0,1,1
3878,1145280,Blockey: Block Yeah!,0,False,Walking Talking Grilling Bear,0,1,0,1
3879,1145380,Kakatte Koi Yo!,0,False,BackSlash Games,7,11,1,12
3880,1145410,Knight Swap,0,False,Minimol Games,7,40,3,43
3881,1145430,Agross,0,False,cBlck,0,1,1,2
3882,1145450,Mystery Case Files: Moths to a Flame Collector's Edition,0,False,Eipix Entertainment,0,7,1,8
3883,1145460,Memories on the Shoreline,0,False,Crystal Game Works,0,3,3,6
3884,1144690,Project SolarBot,0,False,Inferno,0,2,0,2
3885,1144770,SLUDGE LIFE,0,False,Terri Vellmann,8,128,9,137
3886,1144860,Flying Sword,0,False,Meng Games,7,13,2,15
3887,1144910,Space Gladiators,0,False,Thomas Gervraud,8,77,1,78
3888,1144970,Necronator: Dead Wrong,0,False,Toge Productions,6,112,40,152
3889,1144250,WAIFU HELL,0,False,Konnichiwa Games,8,234,55,289
3890,1144270,救赎抉择Resurrection,0,False,Just For Fun,0,2,0,2
3891,1144280,Ain Dodo,0,False,oukaein,7,48,0,48
3892,1144290,Lucid Nina,0,False,slimelvl2,0,2,0,2
3893,1144300,ef - the first tale. (All Ages),0,False,minori,0,7,1,8
3894,1144330,Marisa's Marvelous Magic Shop,0,False,Masakami Nature Reserve,7,9,2,11
3895,1144350,Hunger Tower,0,False,FunmenGames,0,1,1,2
3896,1144370,Levi Chronicles,0,False,Atmosphere Studio,0,4,0,4
3897,1144400,Senren＊Banka,0,False,Yuzusoft,8,329,9,338
3898,1144440,UnderParty,0,False,SekaiFrieden,8,61,8,69
3899,1144450,Rose Riddle: Fairy Tale Detective,0,False,Yustas Game Studio,0,1,0,1
3900,1144460,SOUNDART,0,False,MercuryStudio,7,13,2,15
3901,1144510,Stratos,0,False,New State,6,9,3,12
3902,1144520,Air,0,False,Calepin Studio,0,0,2,2
3903,1144550,Bride for the Princess,18,False,Tuomo Laine,0,2,2,4
3904,1144590,Blooding Runner X,0,False,Creative Black Chair,0,4,0,4
3905,1144630,Beardy the Digger,0,False,White Ink,0,2,0,2
3906,1143900,Shapeshooter,0,False,NukGames,0,2,2,4
3907,1144020,GolfTopia,0,False,MinMax Games Ltd.,8,244,8,252
3908,1144030,Pesterquest,0,False,"What Pumpkin Games, Inc.",8,767,57,824
3909,1144060,Ten Days to War,0,False,ZeroByter Games,0,0,1,1
3910,1144070,NUMB,0,False,Sakarikos Kleanthis,0,2,5,7
3911,1144090,ArtFormer: Ancient Stories,0,False,Jan Šídlo,0,0,1,1
3912,1144100,Linea VR,0,False,KHB-Soft,0,7,1,8
3913,1144110,Open World Game: the Open World Game,0,True,Morning Person Games,0,4,0,4
3914,1144140,Pillars of Dust,0,False,Retreaux Games,7,12,1,13
3915,1144150,Singled Out,0,False,Matt Glanville,7,20,0,20
3916,1143550,EleMetals: Death Metal Death Match!,0,False,WALLRIDE,0,1,0,1
3917,1143570,VolticPistol,0,False,Sunset Arctic Games,0,5,0,5
3918,1143680,AVA,0,False,Dnovel,0,8,1,9
3919,1143710,Тёмное отражение (Dark Reflection),0,False,Slay Buherman,0,5,1,6
3920,1143720,ALTERITY EXPERIENCE,0,False,ONITRON STUDIO,0,4,1,5
3921,1143740,PUZZLETIME: Castle Party,0,False,Juicy Jelly Cloud,0,4,0,4
3922,1143750,VRocker,0,False,digitalsoulVR,7,26,2,28
3923,1143770,StressOut,0,False,VRmadillo,0,3,1,4
3924,1143780,Graveyard Defender,0,False,Pixel Cattus,0,3,0,3
3925,1143800,Jigsaw Puzzle - Pro Edition,0,False,Boogygames Studios,0,6,1,7
3926,1143170,Auto Factory,0,False,Architect Studios,0,4,0,4
3927,1143320,Gred,0,False,Kevin Bergeal,0,1,0,1
3928,1143330,Frustrate-a-ball,0,False,Addictive 247 Games,0,1,0,1
3929,1143390,Ichor,0,False,Luke Palmer,0,3,0,3
3930,1143420,70 Seconds! Adventure,0,False,Enoops,0,1,0,1
3931,1143430,Shadow Gangs,0,False,JKM corp,0,7,1,8
3932,1143440,Connor's Desert Adventure,0,False,HaDe Games,0,5,1,6
3933,1142410,Kamile: The Fall,0,False,Bartosh Polonski,6,11,4,15
3934,1142480,Anthophobia,0,False,Terrarium,7,34,1,35
3935,1142500,Fun with Ragdolls: The Game,0,False,Jadon Barnes,8,1869,174,2043
3936,1142550,Protein for Muscle,0,False,Qmax Inc.,7,12,1,13
3937,1142750,BAFF 3,0,False,Blender Games,0,1,0,1
3938,1142830,9-nine-:Episode 3,0,False,PALETTE,8,61,0,61
3939,1142850,Darkness Rollercoaster - Ultimate Shooter Edition,0,False,CREATIVE VR3D,0,3,3,6
3940,1142870,Hentai Fight Club,0,False,Ero Team Triangle,0,0,5,5
3941,1141930,Mondly: Learn Languages in VR,0,False,ATi Studios A.P.P.S. SRL,5,15,8,23
3942,1141950,Sex & Gun PC,0,False,VR-EXODUS,5,5,5,10
3943,1141990,Elite Escape,0,False,Przestraszeni,5,9,4,13
3944,1142030,Emperium,0,False,Bryan Roberts,0,4,1,5
3945,1142070,Paladin Slayer,0,False,SeedWall,0,2,3,5
3946,1142090,Playing Both Sides,0,False,N/A,0,3,0,3
3947,1142100,WWE 2K BATTLEGROUNDS,0,False,Saber Interactive,5,130,61,191
3948,1142130,They Can't Stop All Of Us,0,True,B Michael B,0,1,0,1
3949,1142200,Nightmare Cave,0,False,Nejc Korez,0,1,0,1
3950,1142220,Beat Aim - Rhythm FPS Shooter,0,False,Kamyker,8,49,11,60
3951,1142230,The Secrets of Jesus,0,False,Amir Matouk,0,2,0,2
3952,1142290,Haunted Legends: The Scars of Lamia Collector's Edition,0,False,AMAX Interactive,0,1,0,1
3953,1142300,Hope; or How We Survived,0,False,Sepia Cowboys,0,7,0,7
3954,1142320,Little Helper,0,True,Vander,0,4,0,4
3955,1142360,Hope for City,0,False,Cloaz Studio,0,4,2,6
3956,1141450,Dodge Rocket,0,False,HaDe Games,7,8,2,10
3957,1141530,"PlayClaw 7 - Game Overlays, Recording and Streaming",0,True,Eduard Kozadaev,0,4,0,4
3958,1141570,Sky Cannoneer,0,False,"Element Games, LLC",0,6,2,8
3959,1141600,Every Day's Different,0,False,Snowfall Studio,0,3,1,4
3960,1141640,Slaveblade,0,True,NegativeGenius LLC,0,0,1,1
3961,1141650,Crowd Simulator,0,False,ZHANG FAN,7,17,2,19
3962,1141860,Trial Of Destiny,0,False,DarkLord Game,0,1,0,1
3963,1141870,The Longest Love,0,False,夜雨ドッド,0,2,0,2
3964,1141880,Crazy Critters - Combat Cats,0,False,Aligned Games,0,5,1,6
3965,1141070,UFO : Brawlers from Beyond,0,False,Pringo Dingo Games,0,1,0,1
3966,1141120,Scarlet Hood and the Wicked Wood,0,False,Devespresso Games,7,10,1,11
3967,1141130,Serious Scramblers,0,False,Chinykian Games,7,19,1,20
3968,1141150,The Defender: Farm and Castle 2,0,False,Kitti Sarmuerjai,0,2,1,3
3969,1141160,Fractalis,0,False,Revolutionary Interactive,0,1,0,1
3970,1141170,Risnuch,0,True,Razard,0,0,1,1
3971,1141180,Cocktail for Beauty,18,False,vadimalexepta,0,2,0,2
3972,1141220,DemonCrawl,0,False,Therefore Games,8,542,120,662
3973,1141290,Tactical Nexus,0,False,Team-Tactical Nexus,7,43,1,44
3974,1141300,Sloth Quest,0,False,Lumatap LLC,0,2,0,2
3975,1141360,Dungeon Dreams (Female Protagonist),0,False,DDreams Games,7,17,4,21
3976,1141380,Ladies Orders,0,False,Silver Cloud,0,2,1,3
3977,1141390,The Blitzkrieg: Weapons of War,0,False,Loui Eriksson,0,1,0,1
3978,1140610,Death Live,0,False,橘子班,0,5,0,5
3979,1140720,Boat Violence: Ship Happens,0,False,Daygames,0,1,0,1
3980,1140750,Chained,0,False,Studio Digital Caffeine,0,0,1,1
3981,1140790,Kung Fu Jesus,0,False,Celestial Gold Studios,0,2,1,3
3982,1140880,Only One Burn,0,False,Leyline Studios,6,11,3,14
3983,1140890,Morbid: The Seven Acolytes,0,False,Still Running,6,76,28,104
3984,1140900,The Chasm - Mines Of Madness,0,False,"Luca ""Fox"" Giovani",0,0,1,1
3985,1140950,Boardwalk Carnival Game,0,False,VTree LLC,0,1,0,1
3986,1140970,Inside The Park VR,0,False,Intelimmerse LLC,0,1,4,5
3987,1140130,Survival Vacancy,0,False,Mind Leak,6,31,13,44
3988,1140140,Summer Meetings,0,False,Mikołaj Spychał,0,3,1,4
3989,1140260,Blade Warrior,0,False,Image Works,0,1,0,1
3990,1140270,Monster Prom 2: Monster Camp,0,False,Beautiful Glitch,9,2485,42,2527
3991,1140290,Murder by Numbers,0,False,Mediatonic,8,487,62,549
3992,1140360,TextureWorks,0,False,GameDev_ToolMaker,0,2,2,4
3993,1140400,Gericonia 2,0,False,Simon Eriksson,0,2,1,3
3994,1140410,Sex City,0,False,Slippy Floor,0,2,3,5
3995,1140420,Quantism,0,False,Wannes Vanoyenbrugge,0,2,1,3
3996,1140440,OMON Simulator,0,False,Ukrainian Bears,6,94,36,130
3997,1140460,V1RUZ,0,False,Polyverse Games,6,14,5,19
3998,1140520,Graviton,0,False,Richter Games,0,2,0,2
3999,1140530,Viper,0,False,X-ample Architectures,0,2,0,2
4000,1140570,A Street Cat's Tale,0,False,feemodev,7,31,2,33
4001,1139760,DEDstress,0,False,3StrakGames,7,10,0,10
4002,1139800,Chinatris,0,False,仓鼠动力,7,25,1,26
4003,1139830,Recyclomania,0,False,PixQuake,0,2,1,3
4004,1139840,TILTit,0,False,MABE Play,0,1,0,1
4005,1139860,CRUEL WORLD,0,False,SiberianGames,0,2,0,2
4006,1139870,The Dark Eye : Book of Heroes,0,False,Random Potion Oy,5,28,41,69
4007,1139880,Chapeau,0,False,Salt Castle Studio,0,7,0,7
4008,1139890,Dictators:No Peace Countryballs,0,False,RPN Indie Developer,9,663,25,688
4009,1139950,Two Weeks in Painland,0,True,Unusual Games,7,8,2,10
4010,1140020,Cetetorius,0,False,VI.SH Games,0,0,2,2
4011,1140030,AMazing TD,0,False,Go4 Entertainment,5,11,6,17
4012,1140070,Tractor Cargo Driving Simulator,0,False,Boogygames Studios,0,6,1,7
4013,1139240,HalloweenStory,0,False,Dnovel,0,4,0,4
4014,1139310,Ven VR Adventure,0,False,Monologic Games,7,18,3,21
4015,1139470,THE ART - Metamorphosis,0,False,Life Jumb DT,7,10,2,12
4016,1139480,Mask of Sanity,0,False,UNICORE Games Studios,6,9,3,12
4017,1139660,Marburgh,0,False,Marcotte,0,2,0,2
4018,1139680,Pixamal Zoo,0,False,Monkey Maneuvers,0,3,0,3
4019,1138800,Dark Elf's Adventure,0,False,Uzura Studio,0,0,1,1
4020,1138810,Super Platformer Gun,0,False,Expresso Studios,0,1,1,2
4021,1138960,Biomass,0,False,Final Scene dev,7,47,2,49
4022,1138990,B.i.t.Lock,0,True,Petorio,0,2,0,2
4023,1139020,Hentai Evilgirls,0,False,GentleDriver,0,3,2,5
4024,1139090,Demolition Expert - The Simulation,0,False,abramedia,0,0,1,1
4025,1139100,An Egg Can Dream,0,False,Floor Chicken,0,2,0,2
4026,1139130,BioMech,0,False,ERMedia,0,1,2,3
4027,1138260,Figure Simulator War,0,False,H-GIRL,7,11,0,11
4028,1138280,Workhard,0,False,Red twice potato,0,0,1,1
4029,1138290,Slime Adventure Legacy,0,False,Vlad Dunaev,0,1,0,1
4030,1138300,I LIKE THE FLOWERS,0,False,Red twice potato,0,2,3,5
4031,1138310,Morbolbo: Enter the Maze,0,False,Laughing Tower,0,1,0,1
4032,1138320,AREA 51 - DEFENCE,0,False,SRS Games,0,0,5,5
4033,1138370,Motel Bondage,0,False,D.i.D. Games,0,3,2,5
4034,1138410,Demons Never Lie,0,False,IndieBug,7,23,2,25
4035,1138440,Galactic Ruler,0,False,BattleGoat Studios,5,14,7,21
4036,1138530,Jigoro,0,False,Azurezero,0,1,0,1
4037,1138580,Farmington County: The Ultimate Farming Tycoon Simulator,0,False,"Grenoble Interactive, LLC",8,70,8,78
4038,1138630,Heroes Swipe Right,0,False,One Method Monkey LLC,0,3,1,4
4039,1137770,Avalive,0,False,Avamoe,0,1,3,4
4040,1137930,Second Dimension RetroPak Vol. 1,0,False,Second Dimension,0,1,0,1
4041,1137970,Zombies Ate My Neighbors and Ghoul Patrol,0,False,DotEmu,4,21,37,58
4042,1138060,Diablo_IslanD 暗黑破坏岛,0,False,Victor Studio,0,1,4,5
4043,1138080,斗地主少女/ Landlord Girls,0,False,七彩绘色游戏,5,8,9,17
4044,1138100,Touhou Ibunseki - Ayaria Dawn: ReCreation,0,False,Team L.U.R.Id Glow,7,46,3,49
4045,1138130,Shadows and Dust,0,True,Moloch Media,0,1,0,1
4046,1138150,Fiery catacombs,0,False,Metamorpho_SG,0,0,2,2
4047,1137330,DREAMO - Puzzle Adventure,0,False,Hypnotic Ants,7,12,3,15
4048,1137350,Filament,0,False,Beard Envy,8,213,21,234
4049,1137360,DOWN MEANS UP,0,False,David Mulder,0,1,0,1
4050,1137400,The War for the West,0,False,Hosted Games,7,34,7,41
4051,1137460,ALTF4,0,False,Autosavegame,8,507,42,549
4052,1137490,Invasion 2037,0,False,Little Beavers Games,5,45,26,71
4053,1137620,Sexy President,0,False,Great Idea Games,0,2,2,4
4054,1137660,Impossamole,0,False,Gremlin Interactive,0,3,0,3
4055,1137670,Power Punch II,0,False,Beam Software,0,0,1,1
4056,1137680,Blender Bros,0,False,Infogrames,0,2,0,2
4057,1137690,Tinhead,0,False,Microprose,0,1,0,1
4058,1137730,Naughty Girl 2,0,False,Hentai X,5,8,4,12
4059,1136880,Baby Walking Simulator,0,False,One Button Please,7,17,0,17
4060,1136910,Lily's Handmaid,0,False,Arcus Plume,7,12,2,14
4061,1136930,Gekisou! Benza Race -Toilet Shooting Star-,0,False,Da-Soft,0,2,1,3
4062,1136960,Hentai Crazy Girls,0,False,Kotovodk Studio,0,3,1,4
4063,1137020,My Train Arrives,0,False,Kochkin Dmitry,7,37,6,43
4064,1137040,CAT & MOUSE,0,False,Jacob G,0,3,0,3
4065,1137050,Treater,0,False,TheBlavas,0,1,1,2
4066,1137070,Anime Girls Jigsaw Puzzles,0,False,Boogygames Studios,0,1,1,2
4067,1137110,Ballistic Craft,0,False,Palladium Soft,0,7,1,8
4068,1137210,Alien Monopoly,0,False,zeroplaystone,0,1,0,1
4069,1137220,Elite Soldier: 3D Shooter,0,False,IO Games,0,1,1,2
4070,1137230,Derby: Extreme Racing,0,False,IO Games,0,0,1,1
4071,1137250,Classic Hentai Logic Puzzle,0,False,IO Games,0,0,1,1
4072,1137260,Tower Defense: Defender of the Kingdom,0,False,IO Games,0,1,3,4
4073,1137270,Palladium: Adventure in Greece,0,False,NLB project,0,1,0,1
4074,1136390,"Strange Passion - My Boss, My Mistress",18,False,ZangGames,0,2,7,9
4075,1136420,Gates of Hell,0,False,Super Icon Ltd,0,1,0,1
4076,1136440,HENTAI ARENA HOLY PUSSY,0,False,Cyber Keks,5,16,12,28
4077,1136820,Someone Cloned The President,0,False,Julian Henley,0,2,0,2
4078,1136830,Deep Race: Battle,0,False,Raciebug,0,1,3,4
4079,1136010,FeArea: Battle Royale,0,False,MUVGAMES,0,0,1,1
4080,1136020,Cannibal Cuisine,0,False,Rocket Vulture,7,20,3,23
4081,1136030,Apple Pop,0,False,StarSystemStudios,0,0,1,1
4082,1136040,ReThink 3,0,False,Yaeko,0,6,0,6
4083,1136070,UltraGoodness 2,0,False,Rasul Mono,0,7,2,9
4084,1136080,8 Eyes,0,False,Thinking Rabbit,0,7,0,7
4085,1136090,The Gadget Twins,0,False,Imagitec Design,0,3,0,3
4086,1136100,Mousegun,0,False,Isaac Colson,0,1,0,1
4087,1136110,Hidden Objects - The Mystery House,0,False,Hidden Objects Games,3,2,9,11
4088,1136160,Internet Cafe Simulator,0,False,Cheesecake Dev,6,584,216,800
4089,1136330,Hazumi and the Pregnation,0,False,Mihiraghi,8,75,6,81
4090,1135730,Zebra Logic Master,0,False,H7 Games,0,2,0,2
4091,1135740,Utopia,0,False,DAX Entertainment,7,25,5,30
4092,1135750,Return to Earth,0,False,SVAROG GAMES,0,1,0,1
4093,1135860,Corpoct,0,False,Wolderado,0,2,1,3
4094,1135900,Bootybuns 2,0,False,ingeniousfun,5,5,5,10
4095,1135910,Hunting Simulator 2,0,False,Neopica,5,99,44,143
4096,1135210,Oh Crab!,0,False,Sokpop Collective,0,2,4,6
4097,1135260,The Falconeer,0,False,Tomas Sala,8,82,13,95
4098,1135370,Star Girl Proxima,0,False,Giant Evil Robot,0,7,2,9
4099,1135380,不可思议佣兵团,0,False,折凳工作室,0,0,1,1
4100,1135400,Captain fly and sexy students,0,False,Captain Fly Studio,5,11,8,19
4101,1135450,Psy High 2: High Summer,0,False,Choice of Games,0,7,1,8
4102,1135480,Protect Your Fool,0,False,MODIV games,0,1,0,1
4103,1135570,Martian Law,0,False,Linclo Games,0,1,0,1
4104,1134710,NIMBY Rails,0,False,Weird and Wry,8,385,37,422
4105,1135030,jut,0,False,Sokpop Collective,0,5,2,7
4106,1135040,Bombini,0,False,Sokpop Collective,0,3,2,5
4107,1135050,Dr. Umgebung's School of Life,0,False,Sokpop Collective,0,4,4,8
4108,1135060,King of the Sandcastle,0,False,Sokpop Collective,0,3,2,5
4109,1135070,Moeras,0,False,Sokpop Collective,0,4,2,6
4110,1135090,dino game,0,False,Sokpop Collective,7,14,1,15
4111,1135100,driftwood,0,False,Sokpop Collective,0,0,3,3
4112,1135110,Hoco Poco,0,False,Sokpop Collective,0,8,0,8
4113,1135120,Tomscape,0,False,Sokpop Collective,0,0,5,5
4114,1135130,kamer,0,False,Sokpop Collective,0,4,3,7
4115,1135140,huts,0,False,Sokpop Collective,0,1,3,4
4116,1135150,Zoo Packs,0,False,Sokpop Collective,0,4,2,6
4117,1135160,Botanik,0,False,Sokpop Collective,0,1,2,3
4118,1135170,spider ponds,0,False,Sokpop Collective,0,3,0,3
4119,1135180,Llama Villa,0,False,Sokpop Collective,7,14,2,16
4120,1135190,Hoppa,0,False,Sokpop Collective,0,2,2,4
4121,1135200,soko loco,0,False,Sokpop Collective,0,1,1,2
4122,1134470,Sleep Paralysis : mystery of the mountain village,0,False,Ardiansa Reza,0,2,0,2
4123,1134500,Follow the White Rabbit VR (화이트래빗),0,False,Dexter Studios,0,0,2,2
4124,1134520,Dark Light,0,False,Mirari&Co.,6,71,18,89
4125,1134630,Pear Quest,0,False,Sokpop Collective,6,10,3,13
4126,1134040,Labyrinths of the World: Fool's Gold Collector's Edition,0,False,Domini Games,0,1,1,2
4127,1134050,Head Over Heels,0,False,Retrospec,0,2,1,3
4128,1134120,Brutal Sports - Football,0,False,Teque,0,2,0,2
4129,1134130,Legends,0,False,Krisalis,0,0,1,1
4130,1134140,Daaang!,0,False,Snaredrum Games,0,1,0,1
4131,1134150,X Wars Deluxe,0,False,Carlos Alberto Martinez Carrillo,0,1,0,1
4132,1134180,Cyberpunk hentai: Memory leak,0,False,Crew Lab,7,27,5,32
4133,1134190,tri.Attack();,0,False,Demmy Mangusso,0,6,0,6
4134,1134200,Chicks and Tricks VR,0,False,Shapeshift Entertainment ApS,6,14,4,18
4135,1134250,Hexadrift,0,False,Henagames,0,4,1,5
4136,1134370,Baron: Fur Is Gonna Fly,0,False,DM Games Pty Ltd,0,1,0,1
4137,1134390,Voidlifted,0,False,Michał Karbowiak,0,0,1,1
4138,1133540,Grid Wars,0,False,Vinson Virtual,0,1,0,1
4139,1133580,Snapshot VR,0,False,Giant Scam Industries,8,51,5,56
4140,1133590,Stilt Fella,0,False,September Games,8,107,2,109
4141,1133790,Armortale,0,False,RPG2 Heaven,7,20,2,22
4142,1133890,P1R4T3S,0,False,LLC Blini Games,0,3,0,3
4143,1133910,Caravan Chaos,0,False,Daniel Wiendl,0,6,0,6
4144,1133930,Forgotten Hill Disillusion,0,False,FM Studio,7,33,4,37
4145,1133950,The Castle,0,False,Ishtar Games Inc.,0,6,1,7
4146,1133970,Battle Dome Redux,0,False,Bad Bird Studios,0,2,0,2
4147,1133980,Spirit Arena,0,False,Sweet Dreams Studio,0,1,0,1
4148,1134020,Sons of Ra,0,False,Pharaoh Hound Games,7,15,3,18
4149,1133050,"Good Night, Knight",0,False,RedEmber,7,15,0,15
4150,1133070,Viking Chess: Hnefatafl,0,False,Diamond Sky Games,7,19,4,23
4151,1133080,Devil Slayer,0,False,ReJust,0,0,3,3
4152,1133200,Escape Zolstar,0,False,Robert Alvarez,0,1,0,1
4153,1133210,Inner,0,True,DarkStone Digital,0,6,1,7
4154,1133230,Little Awesome Dudes,0,False,Canalside Studios,5,4,6,10
4155,1133250,CULT,0,False,Salt & Pixel LLC,0,1,0,1
4156,1133260,Vole Complexity,0,False,makingARTS Entertainment,0,3,0,3
4157,1133300,Sisters Royale: Five Sisters Under Fire,0,False,"AlfaSystem Co.,Ltd.",0,8,0,8
4158,1133320,Westworld Awakening,0,False,Survios,8,175,37,212
4159,1133330,Helicopter Simulator,0,False,Lines Studio,5,41,19,60
4160,1133350,Gravity Control,0,False,NanningsGames,0,2,3,5
4161,1133420,Hero or Villain: Genesis,0,False,Hosted Games,5,14,8,22
4162,1133450,Hexa Trains,0,False,Game Studio Abraham Stolk Inc.,0,7,2,9
4163,1133520,ICONIC,0,False,Cody Rauh,0,2,0,2
4164,1132600,GYATM Dragon Edition,0,False,Longplay Games,0,2,2,4
4165,1132620,Last Knight,0,False,Enoops,0,3,1,4
4166,1132640,Platforms,0,False,RealzGizmo,0,1,0,1
4167,1132720,I Walk Among Zombies Vol. 0,0,False,Seacoxx,6,8,3,11
4168,1132730,巅峰骑士团,0,False,熊窝dodox,0,7,1,8
4169,1132750,Buck Zombies,0,False,Harsh Reality Productions,0,3,3,6
4170,1132770,World War 2 Craft (二战演义),0,False,三角形游戏工作室,0,1,0,1
4171,1132840,RhythmSnake,0,False,BolotoGames,0,0,2,2
4172,1132850,Try not to die,0,False,FangRunQiang,0,1,0,1
4173,1132930,Phantom 3D,0,False,Graverobber Foundation,0,3,0,3
4174,1132970,Time To Stop Time,0,False,Sicarius,6,34,9,43
4175,1132080,Hentai Dgirls,0,False,GentleDriver,0,5,3,8
4176,1132090,Silk,0,False,ihobo games,0,4,2,6
4177,1132100,Samurai of Hyuga Book 4,0,False,Hosted Games,6,34,9,43
4178,1132110,Heaven's Grave,0,False,Blackcross & Taylor,0,6,2,8
4179,1132120,Put in,0,False,КиКо,7,25,3,28
4180,1132160,Mendel's Garden,0,False,Siddharth Sivaraman,0,6,1,7
4181,1132180,Persephone,0,False,Momo-pi,0,4,0,4
4182,1132190,Coloring Game: Little City,0,True,L. Stotch,0,2,0,2
4183,1132210,Kingdom Under Fire 2,0,False,Blueside,6,674,281,955
4184,1132220,Iridion 3D,0,False,Shin'en Multimedia,0,7,0,7
4185,1132230,Iridion II,0,False,Shin'en Multimedia,0,3,1,4
4186,1132290,Eldritch University,0,False,Nightshade,0,3,1,4
4187,1132300,Ribbon,0,False,Evade Game,0,0,1,1
4188,1132410,Cyber OutRun,0,False,Kerim Kumbasar,4,6,10,16
4189,1132460,Codebreaker,0,False,Thor Gaming,0,2,1,3
4190,1132540,Colonies End,0,False,Raw Orange Studios Limited 🍊🎮,0,2,2,4
4191,1131580,Penguins vs. Bugs,0,False,Rootton Endeavours,0,1,0,1
4192,1131640,Climatic Survival: Northern Storm,0,False,Johannes Förth,0,1,0,1
4193,1131660,The Ai Games,0,False,Ryan Saunders,0,1,0,1
4194,1131680,PPDD,0,False,ANGROWA,0,3,1,4
4195,1131720,PROP AND SEEK®,0,True,Vidibidi Games®,0,4,1,5
4196,1131740,Snowdome,0,False,Lunatic Works,0,3,0,3
4197,1131750,Alien Squatter,0,False,A. Hagen,7,32,1,33
4198,1131780,Mustache or Revenge,0,False,Growfall Games,0,1,0,1
4199,1131790,"Injection π23 'No Name, No Number'",18,False,Abramelin Games,0,3,0,3
4200,1131800,Pixel Puzzle Makeout League,0,False,Rude Ghost,7,33,1,34
4201,1131810,Gordon Streaman,0,False,Brouillard,0,2,4,6
4202,1131880,Henry Mosse and the Wormhole Conspiracy,0,False,Bad Goat Studios,0,4,0,4
4203,1131900,3rd eye,0,False,3rd eye project,7,31,3,34
4204,1131940,Jailbreak Simulator,0,False,Lin Tang Yi,0,1,0,1
4205,1131960,云聚：失落的魔法 Magic Ganglia,0,False,Guangzhou yimi information technology company,0,1,0,1
4206,1131990,Hentai NetPuzzle,0,False,LeonWaan Games,0,1,3,4
4207,1132010,Hentai ChessKnight,0,False,LeonWaan Games,0,1,2,3
4208,1132070,5.0,0,False,Tamerlan Satualdypov,6,11,3,14
4209,1131110,Orbitblazers,0,False,ogsoftgames,0,2,0,2
4210,1131140,The MoneyMakers Rallye,0,False,The Unknown Machine,7,10,1,11
4211,1131160,Civil: The Game,0,False,Oversight Games,0,0,1,1
4212,1131270,Zombie Golf,0,False,Icebreaker Games LLC,0,3,2,5
4213,1131280,叫我铸造师,0,False,时空游侠,0,0,1,1
4214,1131330,CLOSED,17,False,Kazuya,0,6,2,8
4215,1131400,Project RIP,0,False,Storming Tech,5,37,18,55
4216,1131410,Sable's Grimoire: Man And Elf,0,False,Zetsubou,7,29,0,29
4217,1131420,For a Better Country,0,False,Miraoriem,0,0,5,5
4218,1131430,Parachronism: Order of Chaos,0,False,NinjaVault,0,1,0,1
4219,1131450,Above Earth,0,False,Midwest Video Games,5,8,4,12
4220,1131520,Trial And Terror,0,False,Stargazer Studio,0,3,0,3
4221,1131530,Dum-Dum,0,False,Hogo Company,7,16,0,16
4222,1131540,My Light In The Dark,0,True,Kisuarts,0,5,0,5
4223,1131550,I Walk Among Zombies Vol. 3,0,False,Seacoxx,7,25,5,30
4224,1130710,Bookbound Brigade,0,False,Digital Tales USA LLC,0,3,2,5
4225,1130720,Watch Tower,0,False,S'Games,0,3,2,5
4226,1130990,Roman Adventures: Britons. Season 2,0,False,Whiterra,0,7,0,7
4227,1131060,Dungeon of Eyden,0,False,Andreas Klein,0,1,0,1
4228,1130400,Symmetry: Early Access,0,False,SPARK Games,0,5,2,7
4229,1130430,Escape from Chernobyl: Jailbreak,0,False,Nelset,0,2,0,2
4230,1130510,Floaty Fighters,0,False,Shattered Journal Games,7,9,1,10
4231,1130560,RPG NPC Simulator VR,0,False,Odooh Games,6,40,12,52
4232,1130570,The Sword and the Slime,0,False,Possum House Games,0,8,0,8
4233,1130590,Aleesha's Tower,0,False,Pixel vs Pixel,0,5,4,9
4234,1130620,Aka Manto | 赤マント,0,False,Chilla's Art,8,169,16,185
4235,1129920,Tales From Off-Peak City Vol. 1,0,False,Cosmo D,8,245,1,246
4236,1129330,Spark and Sparkle,0,False,Essencey,0,8,0,8
4237,1129350,Murgles,0,False,Jumping Pound Games,0,6,0,6
4238,1129680,GraFi 3,0,False,Blender Games,0,5,1,6
4239,1129690,3x64,0,False,Lightning Soft,0,5,0,5
4240,1129720,Area 51 Defense,0,False,GameRealmMadness,0,2,0,2
4241,1129730,Lost Existence,0,True,Lurid Spectre Games,6,10,3,13
4242,1128970,Eterna: Heroes Fall,0,False,Zu Digital,7,8,2,10
4243,1129010,Dress-up Traveller,0,False,CatBellUnion,8,125,22,147
4244,1129030,Endless Fables 4: Shadow Within,0,False,Sunward Games,7,18,2,20
4245,1129080,Forex Demo Accelerator,0,False,Russell Butler,0,1,2,3
4246,1129180,Glitch Puzzle,0,False,Diamond Cats Studio,0,2,0,2
4247,1129200,Minesweep World,0,False,Rainbirth SL,0,0,1,1
4248,1129210,A Million Conquests,0,False,Rainbirth SL,0,1,1,2
4249,1129240,Mystic Mayhem Unleashed,0,False,BitCore Studios LLC,0,2,0,2
4250,1129250,NEKO-NIN exHeart 3,0,False,Whirlpool,7,20,2,22
4251,1128480,Nice Jumper,0,True,Nikolai Usachev,0,0,1,1
4252,1128520,Rezist: Tower Defense,0,False,SparkGames,0,6,0,6
4253,1128570,Weeping Willow - Detective Visual Novel,0,False,TechnoCat Games,0,8,1,9
4254,1128610,Affinity,0,False,Bold Brush Games,0,6,0,6
4255,1128630,Cross Country Express,0,True,Oddfellows Software,0,1,1,2
4256,1128660,Roots Of The Woods,0,False,PlumBear Games,0,1,0,1
4257,1128680,DOUBLE INVASION!!,0,False,Goose Ladder Games,0,1,0,1
4258,1128690,Plunge,0,False,Spooky Buns,7,46,2,48
4259,1128770,Use Your Brain!,0,False,Dr. DreamCrusher,0,2,0,2
4260,1128830,1001 Jigsaw World Tour: Europe,0,False,Creobit,0,2,0,2
4261,1128840,Solitaire Victorian Picnic,0,False,Big Up Studio,0,2,1,3
4262,1128900,live Desktop Beauty,0,False,Bad Bunny Games,5,31,16,47
4263,1127990,Hell Firefighter,0,False,Digital Entertainment Novels,0,0,1,1
4264,1128000,Cube World,0,False,Picroma,5,1745,2481,4226
4265,1128010,Zoological Era II,0,False,Jareed Dempsey,0,1,0,1
4266,1128100,ZeroZone2020,0,False,HaDe Games,6,19,6,25
4267,1128140,Under: Depths of Fear,0,False,Globiss Interactive,5,61,27,88
4268,1128150,祭壇の花/Saidan no Hana,0,False,Zacro,0,0,1,1
4269,1128160,Saturday of Piercing Screams,0,False,derevotyan,0,1,1,2
4270,1128170,Power Stealers,0,False,Intertum,0,3,1,4
4271,1128180,CROSSNIQ+,0,False,FUTURE MEMORY,8,53,4,57
4272,1128190,Achievement Simulator,0,False,Leeson,7,34,7,41
4273,1128210,Orion13,0,False,Metro VR Studios,5,6,4,10
4274,1128220,ZAAM,0,False,Alon Zubina,6,14,4,18
4275,1128260,"The Princess, the Stray Cat, and Matters of the Heart 2",0,False,TOKYOTOON,7,16,1,17
4276,1128270,Whack A Hoe,0,False,Nasty Girl Gaming,0,5,1,6
4277,1128280,IGOR MAKS The Meme Lord,0,False,SЁLO,0,1,0,1
4278,1128310,Koi Unleashed,0,False,Wild Grip,0,0,1,1
4279,1128370,Try again!,0,False,Antizero company,0,1,0,1
4280,1128420,Solitaire Jack Frost Winter Adventures,0,False,Somer Games,0,2,0,2
4281,1128430,Solitaire Match 2 Cards. Valentine's Day,0,False,Creobit,0,2,0,2
4282,1128440,Solitaire Legend of the Pirates,0,False,Somer Games,0,3,0,3
4283,1128450,光與暗之戀曲,0,False,Forace,0,2,0,2
4284,1127520,TREE HOUSE : AVOCADO MAYHEM,0,False,Erico Patricio Monteiro,0,1,0,1
4285,1127530,SKYCAT,0,False,MYAOSOFT,0,1,0,1
4286,1127540,Eden's Ritter - Paladins of Ecstasy,18,False,Waffle,7,14,3,17
4287,1127580,Smaller,0,False,Ragehog Studios,0,1,0,1
4288,1127610,Iris and the Giant,0,False,Louis Rigaud,8,112,17,129
4289,1127680,Hypnocult,0,False,increpare games,7,26,0,26
4290,1127690,Winter Magic Factory,0,False,PixQuake,0,0,1,1
4291,1127820,Repressed,0,False,Sigur Studio,0,2,1,3
4292,1127840,Landlord's Super,0,False,Minskworks,8,448,44,492
4293,1127850,Apple Slash,0,False,Agelvik,8,84,1,85
4294,1127860,"CyberLink PowerDirector 18 Ultimate - Video editing, Video editor, making videos",0,False,CyberLink,6,7,3,10
4295,1127870,"CyberLink PowerDirector 18 Ultra - Video editing, Video editor, making videos",0,False,CyberLink,0,3,2,5
4296,1127880,"CyberLink PhotoDirector 11 Ultra - Photo editor, photo editing software",0,False,CyberLink,0,2,0,2
4297,1127900,CYBER FURRY GIRL,0,False,AFBIK Studio,6,12,4,16
4298,1127930,My Bike,0,False,RewindApp,5,9,5,14
4299,1127970,Retro Machina,0,False,Orbit Studio,7,15,2,17
4300,1127980,NASCAR Heat 4,0,False,Monster Games,8,623,134,757
4301,1127070,Familiar Travels - Volume One,0,False,Ben Taylor,7,42,7,49
4302,1127100,PamPam Kana Students,0,False,PamPam Studio,0,1,0,1
4303,1127120,R42,0,False,Eternal Forge,0,1,0,1
4304,1127130,Happy Oshare Time,0,False,Hapiosha,0,5,0,5
4305,1127180,Robot Vacuum Simulator X,0,False,Sebastian Røed Mangseth,0,1,1,2
4306,1127210,Mystery at Stonyford Bridge,0,False,Schoolfield Games,0,1,0,1
4307,1127230,Shooting Blaster Big Bang Boom,0,False,SRM Games,0,1,0,1
4308,1127250,Deadly Maze: Phase 1,0,False,DIGITAL ART TEAM,0,0,1,1
4309,1127270,Hentai XXX Plus: Jigsaws Vol 1,0,False,Otra Games,0,3,0,3
4310,1127290,Battle Survive Hentai,0,False,CggtGroup,0,5,3,8
4311,1127310,HelixVision,0,False,Bo3b Johnson,5,49,27,76
4312,1127350,Mazes and Mages 2,0,True,Juan Jose Garrido Gomez,0,1,1,2
4313,1127390,Cute Cute Cuties,0,False,IR Studio,5,15,7,22
4314,1127400,Mindustry,0,False,AnukenDev,9,4290,150,4440
4315,1127450,Lewd & Nude | Anime Collector,0,False,Squids Around,8,50,9,59
4316,1127460,Mod and Play,0,False,bucikpro,5,285,417,702
4317,1127480,What's Left,0,False,A. E. Southwood,0,1,0,1
4318,1126550,I'm from area 51,0,False,Peace,0,1,0,1
4319,1126580,The Captain is Dead,0,False,Thunderbox Entertainment,6,22,7,29
4320,1126600,Before I Forget,0,False,3-Fold Games,8,47,4,51
4321,1126640,The Forgotten,0,False,Ragdoll Inc,0,1,2,3
4322,1126710,魔法使いハナビィ Hanaby the Witch,0,False,Enigmatic Network,7,12,1,13
4323,1126750,Mr. DRILLER DrillLand,0,False,"INFINITY Co., Ltd.",7,41,2,43
4324,1126770,My Bones Remastered,0,False,GDNomaD,4,6,12,18
4325,1126820,Heroic Mercenaries,0,False,Azure Fire Games,0,1,0,1
4326,1126850,Power,0,False,Atomic Lollypop,0,4,0,4
4327,1126860,Nauseous Pines,0,False,Rail Slave Games,0,2,0,2
4328,1126880,Pixel Puzzles 4k: Japan,0,False,The Digital Puzzle Company,0,2,0,2
4329,1126890,Urban Cards,0,False,Hues Games,8,63,14,77
4330,1126950,Extreme Tactical Executioners,0,False,Baby Rage,0,2,0,2
4331,1126990,PBA Pro Bowling,0,False,FarSight Studios,6,74,25,99
4332,1126060,Bunker 56,0,False,Limitless Imagination,0,6,1,7
4333,1126070,Let's See What You Got,0,False,Stephen Joseph,0,4,0,4
4334,1126090,Booby And The Booby Trap,0,False,OZNA STUDIO,0,1,0,1
4335,1126100,WELCOME,0,False,TomasKGames,0,0,1,1
4336,1126130,The Pillar,0,False,Paper Bunker s.r.o.,5,9,6,15
4337,1126220,EasyPianoGame,0,False,EVT Games,0,4,3,7
4338,1126270,Neon Tail,0,False,Fei,7,27,2,29
4339,1126290,Lost,0,False,DSGame,6,183,55,238
4340,1126300,DragonClash,0,False,"Warspider Entertainment, LLC",0,1,1,2
4341,1126310,风信楼,0,False,Pingfang Games,7,16,0,16
4342,1126320,Being a DIK - Season 1,0,False,Dr PinkCake,9,2682,58,2740
4343,1126340,Raid on Area 51,0,False,BefuddleBug,0,3,1,4
4344,1126420,REMOTE LIFE,0,False,Next Game Level,8,90,7,97
4345,1126470,Jewel Match Atlantis Solitaire - Collector's Edition,0,False,Suricate Software,7,20,2,22
4346,1125600,TAG WAR,0,False,WOWWOW,0,0,1,1
4347,1125650,Rogue Production Facility,0,False,Eivind Magnus Noersterud Hvidevold,0,0,1,1
4348,1125770,Monoa City Parking,0,False,Freeze Nova,0,0,1,1
4349,1125800,Endless Ski,0,False,So-So-Games,0,7,0,7
4350,1125820,ClearIt5,0,False,IteraLabs,0,2,0,2
4351,1125860,Rabisco,0,False,Viridino Studios,7,21,0,21
4352,1125880,LaserZone,0,False,GameCanvas Inc.,0,1,0,1
4353,1125930,UNFAIR,0,False,SOLIDS Studio,7,10,0,10
4354,1125250,Hentai Petting Simulator,0,False,Slippy Floor,5,8,5,13
4355,1125330,Griefhelm,0,False,Johnny Dale Lonack,6,112,29,141
4356,1125340,Tales of Lazo,0,False,DYSTANT Games,0,2,0,2
4357,1125350,Geocells Quadcells,0,False,Scott Chinchen,0,3,0,3
4358,1125360,Fantasy Little Jobs,0,False,Cubenary,0,8,0,8
4359,1125370,Space Grunts 2,0,False,Orangepixel,0,4,0,4
4360,1125400,The Angel Inn,0,False,DDreams Games,0,7,1,8
4361,1125420,Death and Progress,0,False,ShenTzu,0,9,0,9
4362,1125450,Sanitarium Rush,0,False,Splendortek,0,1,0,1
4363,1125480,School Years,0,False,YEARS,0,0,1,1
4364,1125490,STORM AREA 51 👽 CUTE ALIEN GIRL EDITION,0,False,WASABAE Studios,0,5,2,7
4365,1124790,Hentai LightUp,0,False,LeonWaan Games,0,0,1,1
4366,1124830,Touhou Blooming Chaos,0,False,二色幽紫蝶,7,13,0,13
4367,1124860,Otter Space Rescue,0,False,Noah Williams,0,3,0,3
4368,1124950,Hyperplex 3D,0,False,Lowscope,0,2,0,2
4369,1124960,EMMA: Lost in Memories,0,False,SandBloom Studio,0,1,0,1
4370,1124990,Destructivator 2,0,False,Pug Fugly Games,7,14,0,14
4371,1125000,Touhou Multi Scroll Shooting,0,True,Skydash studio,0,1,1,2
4372,1125030,Hentai Ninja Garden,0,False,Ero Team Triangle,0,1,4,5
4373,1125060,The Quest for Achievements Remix,0,False,StarSystemStudios,0,3,0,3
4374,1125110,Obsurity,0,False,Game Dynasty,6,69,24,93
4375,1125130,Area 51,0,False,Steedie,0,1,1,2
4376,1124270,Cosmic Monsters,0,False,Marco Braun,0,0,1,1
4377,1124310,Android Helipad,0,False,Mibongo Software,0,1,0,1
4378,1124380,One Gun 2: Stickman,0,False,Erow.Dev,0,1,0,1
4379,1124390,Paradigm City,0,False,Hosted Games,0,3,1,4
4380,1124400,Zombien,0,False,Hosted Games,0,1,2,3
4381,1124410,Tokyo Wizard,0,False,Hosted Games,0,2,0,2
4382,1124430,The Adventures of Sullivan,0,False,Bumper Car Studios,0,6,1,7
4383,1124510,Crosser,0,False,Raonesoft,0,0,1,1
4384,1124530,Draft Day Sports: Pro Football 2020,0,False,Wolverine Studios,4,8,13,21
4385,1124550,ARC,0,False,ND Development,0,1,0,1
4386,1124560,Fallen Angel,0,False,Matrioshka Games,7,39,4,43
4387,1124600,Naau: The Lost Eye,0,False,Studio Gamebit,5,9,5,14
4388,1124630,Lonepath,0,False,Bogdan Zigmund,0,1,0,1
4389,1124660,STORM AREA 51: AYY LMAO EDITION,0,False,Agafonoff,8,192,28,220
4390,1124710,IS -Infinite Stratos- Versus Colors,0,False,PROJECT YNP,0,5,1,6
4391,1124050,Ogre Tale,0,False,MAGES. Inc.,5,15,8,23
4392,1124060,Touhou Shoujo Tale of Beautiful Memories / 東方少女綺想譚,0,False,The N Main Shop,7,21,1,22
4393,1124190,Police Stunt Cars,0,False,Freeze Nova,0,5,2,7
4394,1124260,Snowtopia: Ski Resort Builder,0,False,TeaForTwo,5,135,58,193
4395,1123620,Woman's body 3,0,False,Softened Cookie,0,2,1,3
4396,1123770,Curse of the Dead Gods,0,False,Passtech Games,8,1858,262,2120
4397,1123870,The Man with the Ivory Cane,0,False,Cateia Games,0,2,2,4
4398,1123900,Dark Tales: Edgar Allan Poe's Ligeia Collector's Edition,0,False,AMAX Interactive,0,3,0,3
4399,1123910,The Pointless Car Chase,0,False,R.E.M. Studios,0,0,1,1
4400,1123310,Super Lobster Run,0,False,Volens Games,0,6,0,6
4401,1123340,Run! Bunny 绿绿小先生,0,False,KJXX GAME,0,2,0,2
4402,1123400,The Land of Exile,0,False,CCCuiyao,0,3,0,3
4403,1123410,Tailypo: The Game,0,False,Lore Games,0,0,1,1
4404,1123450,Chicory: A Colorful Tale,0,False,Greg Lobanov,9,503,7,510
4405,1123550,Desire Gambling House/欲望赌馆,0,False,Air Balloon,0,3,2,5
4406,1123610,Indiecalypse,0,False,JanduSoft,0,0,4,4
4407,1122860,Stop it - Driving Simulation,0,False,Next2VR,0,2,3,5
4408,1122920,Path Of Aurora,0,False,Project Starmap,0,1,1,2
4409,1122980,Hentai Shojo,0,False,GentleDriver,0,1,2,3
4410,1123000,Jitsumi's Blue-Light Filter,0,False,THEEY STORE PTE. LTD.,0,2,1,3
4411,1123030,WHO IS AWESOME,0,False,AZAMATIKA,7,13,2,15
4412,1123060,Alien Creatures,0,False,wula,0,2,1,3
4413,1123070,REFLASER,0,False,Dmitry Dovgal,0,1,0,1
4414,1123080,FadeZone 消逝之地,0,False,ZeroXilo,0,1,0,1
4415,1123140,Mother Daughter Pleasure Pets,0,False,Miel,5,24,14,38
4416,1123190,育种村,0,False,Miel,0,2,0,2
4417,1123230,HEXTERMINATE,0,False,Wings of Steel,7,16,1,17
4418,1122720,Sayonara Wild Hearts,0,False,Simogo,9,2086,73,2159
4419,1122740,To the Hell,0,False,森林纵火犯,0,2,0,2
4420,1122780,Highly Likely,0,False,Mikola Games,5,8,4,12
4421,1122810,DarkSpace 暗宇战纪,0,False,BlackSpace Games,0,2,0,2
4422,1122490,Battleheart Legacy,0,False,"Mika Mobile, Inc.",0,8,1,9
4423,1122510,Busty Hentai Mosaic,0,False,Wolfgangis,0,6,1,7
4424,1122110,CENTRALIA,18,False,indie_games_studio,0,0,4,4
4425,1122120,STATIONflow,0,False,DMM GAMES,8,154,29,183
4426,1122180,Curse of Anabelle,0,False,Rocwise Entertainment,6,21,6,27
4427,1122210,Guns Craft,0,False,Boogygames Studios,0,0,1,1
4428,1122250,THE FATE OF THE BULLY,0,False,MIGALOO GAMES,0,1,2,3
4429,1122310,Guildmaster Story,0,False,WZOGI,0,4,0,4
4430,1122440,Proxyah v3.1,0,False,Viktor Timofeev,0,1,0,1
4431,1122460,Alien Infection,0,False,Vice Age,0,0,2,2
4432,1121650,Dark Zone Defense,0,False,Supernature Studio,0,3,1,4
4433,1121710,Total Lockdown,0,False,Panzar Studio,5,36,16,52
4434,1121720,Monsters' Den Chronicles,0,False,Monstrum,7,14,2,16
4435,1121770,Animal war,0,False,cici,0,1,1,2
4436,1122040,Kaede the Eliminator / Eliminator 小枫,0,False,Moyashi Research Institute,8,50,11,61
4437,1122050,Gensokyo Night Festival,0,False,WSS playground,8,286,31,317
4438,1122100,Giraffe and Annika,0,False,atelier mimina,7,45,2,47
4439,1121230,Bomb Bowling,0,False,grin robot,0,2,1,3
4440,1121270,Impossible Soaring,0,False,Binary Jellyfish,7,11,1,12
4441,1121300,Mizuchi 白蛇心傳,0,False,Aikasa Collective,7,30,1,31
4442,1121310,ViRo Playspace,18,True,Virtual Romance LLC,0,0,2,2
4443,1121340,Secret City: The Human Threat Collector's Edition,0,False,Domini Games,0,1,0,1
4444,1121400,Drums of War,0,False,Grind Core Games LLC,0,2,0,2
4445,1121420,Kingdom Under Fire: The Crusaders,0,False,Blueside,8,487,38,525
4446,1121490,Time Break 2121,0,True,ACRAM STUDIOS LLC,0,1,1,2
4447,1121550,Prisoner 518,0,False,WhippedUP_gaming,7,15,3,18
4448,1121560,Atelier Ryza: Ever Darkness & the Secret Hideout,0,False,"KOEI TECMO GAMES CO., LTD.",8,934,117,1051
4449,1121590,Adam - Lost Memories,0,False,Adam Dubi,8,43,9,52
4450,1120800,Alex Hunter: Lord of the Mind,0,False,EpicStar,0,3,0,3
4451,1120810,Eastern Exorcist,0,False,Wildfire Game（无锡野火数字科技有限公司）,8,153,13,166
4452,1120900,Hoodo,0,False,AMBOSS GAMES,0,0,1,1
4453,1120920,ELON on MARS,0,False,SRS Games,0,5,2,7
4454,1120950,Chameleon Run Deluxe Edition,0,False,Hyperbolic Magnetism,7,13,1,14
4455,1120960,Crafting Block World,0,True,IO Games,0,1,1,2
4456,1120970,Dream Keeper,0,False,Dern Lin,0,3,0,3
4457,1121100,Color Slayer,0,False,The Domaginarium,0,1,0,1
4458,1120280,Treasure Fleet,0,False,Bitworld Voyager,0,6,2,8
4459,1120310,Game Dashboard,0,False,Disruptive Software,0,5,1,6
4460,1120360,At Home Alone II,0,False,阿正不经,7,41,4,45
4461,1120370,場外人生,0,False,YuruOwO,0,2,0,2
4462,1120390,Tri6: Infinite,0,False,Clockwork Origins,0,1,0,1
4463,1120420,Infini,0,False,Barnaque,7,15,0,15
4464,1120580,Clans to Kingdoms,0,False,Clans to Kingdoms,0,1,5,6
4465,1120600,From The Earth (프롬 더 어스),0,False,Dexter Studios,0,3,0,3
4466,1120640,Kaiju Kite Attack,0,False,PWCA,0,1,0,1
4467,1120680,ViVO,0,False,Eren Çoban,0,1,1,2
4468,1120700,Rescue Lucy 2,0,False,Dmitry Starodymov,0,0,1,1
4469,1120160,Tricky Cow,0,False,NanningsGames,0,2,0,2
4470,1120210,Make War,0,False,Creepy Brothers,6,9,3,12
4471,1119970,Elf Manor,0,False,巫师工作室,0,1,1,2
4472,1119500,FIGHT BALL - BOXING VR,0,False,J-TEC,0,0,1,1
4473,1119520,HITOTSU NO MORI,0,False,ミナプラス,0,5,0,5
4474,1119530,ZHIVE,0,False,Ominous Entertainment,0,4,1,5
4475,1119610,The Wednesday,0,False,GamBridzy,0,0,1,1
4476,1119630,DarkFairyTales SleepingBeauty,0,False,LeonWaan Games,0,1,1,2
4477,1119640,Hentai MatchUp,0,False,LeonWaan Games,0,0,1,1
4478,1119670,HoloSprint,0,False,Hologram Studios,0,3,0,3
4479,1119710,looK INside - Chapter 1,0,False,Unexpected,6,20,6,26
4480,1119740,The Tower 2,0,False,Headroom.one,0,2,0,2
4481,1119760,Rainbow Jigsaw 彩虹拼图,0,False,Indie Rocky,0,4,1,5
4482,1119770,VaporFly,0,False,ImpressVR Studios,0,1,2,3
4483,1119790,RTSM,0,False,Gatskop Software,0,6,0,6
4484,1119800,Brume,0,False,Sokpop Collective,8,49,8,57
4485,1119860,Emberheart,0,False,Rebel Camp Games,7,12,1,13
4486,1119890,Babylonia,0,False,Mad Data,0,1,0,1
4487,1119940,Storm Tale,0,False,Green Sauce Games,7,21,2,23
4488,1119030,Saboteur II: Avenging Angel,0,False,SimFabric,0,8,0,8
4489,1119100,Hentai Vampire,0,False,Snkl Studio,0,4,1,5
4490,1119110,The Creature,16,False,tylobix,0,1,1,2
4491,1119380,Trump Vs Rocketman,0,False,Tero Lunkka,0,2,2,4
4492,1119430,The Backrooms Simulator,0,False,Pixel Plant LLC,0,6,2,8
4493,1118590,Orionide: Prologue,18,False,Orionide,0,1,3,4
4494,1118670,Space raven quest - Tiny planet,0,False,Paper Pirates,0,0,1,1
4495,1118690,Radical Gear,0,False,Miriel,0,0,1,1
4496,1118700,Super Demon Boy,0,False,Semyon Maximov,0,6,1,7
4497,1118730,Super Lee World,0,True,Kyrios Game Studio,0,0,2,2
4498,1118740,Cruel Bands Career,0,False,heran&99,7,10,0,10
4499,1118820,Seraphic Destroyer,0,False,Sonic-Alpha,0,2,2,4
4500,1118840,My name is You and it's the only unusual thing in my life,0,False,Nikita Kaf,6,26,7,33
4501,1118870,Sort Battle: Dungeon,0,False,Incandescent Workshop LLC,0,0,1,1
4502,1118880,Rituals in the Dark,0,False,ebi-hime,7,34,1,35
4503,1118910,Sunflower,0,False,Kory Toombs,0,1,5,6
4504,1118930,FRENZY PLANTS,0,False,MADSKILLZGAME,0,0,1,1
4505,1118940,Robot terminator,0,False,tina,0,2,2,4
4506,1118950,Engineer Arena,0,False,WaveParadigm,0,1,0,1
4507,1118320,Nation Breakers: Steam Arena,0,False,Coded Clay Interactive,0,1,0,1
4508,1118350,Meegah Mem 2,0,False,Crapcom,7,13,3,16
4509,1118380,Discord Bot Studio,0,False,Discord Bot Studio,6,81,21,102
4510,1118410,GLADIUM,0,False,Lorebound Entertainment,6,22,7,29
4511,1117930,Wonder Blade 惊奇剑士,0,False,PUPPET DEPOT GAME STUDIO,0,4,0,4
4512,1117970,Monochrome Order,0,False,"Hit-Point Co.,Ltd.",0,1,0,1
4513,1117980,Asdivine Kamura,0,False,Exe Create Inc.,0,2,0,2
4514,1117990,Wizards of Brandel,0,False,Exe Create Inc.,0,2,0,2
4515,1118000,Revenant March,0,False,Strandline Games,0,8,0,8
4516,1118050,Terminal squad: Sentinel,0,False,Droid Riot,7,8,2,10
4517,1118070,1976 - Back to midway,0,False,Ivanovich Games,8,49,4,53
4518,1117470,Seven Wonders of St. Clementine,0,False,Imagine Fantasia,0,0,5,5
4519,1117480,Dead Hand,0,False,One Man Army Games,7,10,2,12
4520,1117490,"Theater Commander: The Coming Wars, Modern War Game",0,False,Sand Table Software,0,1,3,4
4521,1117520,G.A.C.K. - Gaming App Construction Kit,0,False,Gernot Frisch,0,1,2,3
4522,1117590,Learn Spanish! Easy Vocabulary,0,False,Dr. Cyril Splutterworth,0,1,0,1
4523,1117600,Day of vaccination,0,False,Pixel Fun Games Production,0,1,0,1
4524,1117630,I got a cat maid,0,False,CatBellUnion,8,174,42,216
4525,1117660,Mines of Volantis,0,False,Spacefish Games,5,6,4,10
4526,1117670,GONNER2,0,False,Art in Heart,6,23,9,32
4527,1117680,Hentai Girl Puzzle SCI-FI,18,False,Sanobusiness S.R.L.,0,2,5,7
4528,1117710,Contraptions,0,False,"Moragami Co., Ltd",0,0,1,1
4529,1117760,Deadly Step,0,False,R.I.P Games,0,2,0,2
4530,1117840,Azurebreak Heroes,0,False,Piotr Powroziewicz,0,3,0,3
4531,1117880,Biolab Wars,0,False,2ndBoss,7,27,2,29
4532,1117890,Tamiku,0,False,Josyan,0,4,0,4
4533,1117900,Fantasy Maid,0,False,Cyber Keks,0,4,2,6
4534,1117040,武道戰姬 - 女僕(武道戦姫 - メイド / Budo Girl War - Maid),0,False,武道戰姬製作委員會,0,2,1,3
4535,1117120,The Cross Horror Game,0,False,Next Generation Gaming,0,3,2,5
4536,1117220,WizardCraft Colonies,0,False,David Mccue,0,1,1,2
4537,1117310,Sandwich Sudoku,0,False,Studio Goya,8,103,2,105
4538,1117330,Bouncy Bob: Episode 2,0,False,MadGamesmith,0,0,2,2
4539,1117340,Gods of Havoc: Into the Void,0,False,Mykel Flynn,0,2,0,2
4540,1117360,Word Forward,0,False,Rocketship Park,0,3,0,3
4541,1117380,Project Cappuccino,0,False,Tentakero,7,43,2,45
4542,1116590,Full Animal Party,0,False,John L.,0,4,3,7
4543,1116600,Art Of Air War,0,False,Jotar,0,0,3,3
4544,1116650,CAPCOM GO! Apollo VR Planetarium,0,True,NSC Creative,0,3,0,3
4545,1116670,Simple Railroad,0,False,Turnip games,0,2,0,2
4546,1116700,Vermillion Watch: Parisian Pursuit Collector's Edition,0,False,Eipix Entertainment,0,5,1,6
4547,1116770,Shovel Knight Showdown,0,False,Yacht Club Games,7,28,3,31
4548,1116780,Shovel Knight: King of Cards,0,False,Yacht Club Games,7,45,3,48
4549,1116800,PLAY DOG PLAY TAG,0,False,Project Pegasus,0,1,0,1
4550,1116870,Duel Girl,0,False,QLAQ,0,3,1,4
4551,1116880,The Heroic Legend of Eagarlnia,0,False,HongShou Studio,8,60,10,70
4552,1116890,Unsolved Mystery Club: Amelia Earhart,0,False,Freeze Tag,0,4,1,5
4553,1116910,人间之屑-艺术之名（I'm the dirt-for art）,0,False,一般通行社畜,0,1,1,2
4554,1116990,Legend of Cenama,0,False,PelleK's Ninja Academy,7,24,2,26
4555,1116200,Greetings From Krampus,0,False,Off Leash Entertainment,0,2,0,2
4556,1116210,Our world has not decayed,0,False,lamb of game,5,13,6,19
4557,1116230,The Story of Henry Bishop,0,False,Blazes Games,8,80,17,97
4558,1116240,Android Amazones,0,False,Sonic-Alpha,0,2,1,3
4559,1116290,Alien Escape,0,False,NoFuel Games,7,12,2,14
4560,1116300,Bounce,0,False,Xian'Yu,0,1,0,1
4561,1116340,Eleanor 3,18,False,Lesson of Passion,5,34,20,54
4562,1116350,Exsys,0,False,Peakware Studio,0,0,1,1
4563,1116360,JERRY JOBHOPPER,0,False,NK CREATIV GAMES,0,1,0,1
4564,1116430,Mostly Intense Monster Defense,0,False,Patsui Games,7,20,1,21
4565,1116470,Real Girl VR,0,False,Real Girl VR,4,4,11,15
4566,1116490,Lie In My Heart,0,False,Expressive Gamestudio,7,16,3,19
4567,1116500,HVAC Simulator,0,False,InsanityGameStudios,0,0,1,1
4568,1116580,Shady Part of Me,0,False,Douze Dixièmes,8,104,5,109
4569,1115760,Singaria,0,False,Tactic Forge,0,3,0,3
4570,1115780,The Almost Gone,0,False,Happy Volcano,8,78,16,94
4571,1115840,Dungeons Again,0,False,Team Lambda,0,0,2,2
4572,1115870,Inner Tao,0,False,Lucas Le Slo,0,4,0,4
4573,1115970,Victim Cache the RPG - An 80s JRPG Parody,0,False,Victim Cache,0,1,1,2
4574,1116020,Witch College,0,False,Kavorka play,0,3,2,5
4575,1116100,BEETLES,0,False,SEKTOR GAMES,0,2,0,2
4576,1116110,Raifu Wars,0,False,Yotis Studios,7,23,3,26
4577,1115420,Dickie A Cumming,0,False,Julian Henley,0,3,2,5
4578,1115570,Forest Mage,0,False,JoJo,0,1,1,2
4579,1115580,Grand Brix Shooter,0,False,"Intragames Co.,Ltd",7,27,0,27
4580,1115620,Super Pig,0,False,RewindApp,0,2,0,2
4581,1115630,Magnetic Daydream,0,False,velkomin,0,2,0,2
4582,1115640,英雄群侠传II,0,False,熊窝dodox,8,56,8,64
4583,1115650,Blind Date 3D,18,False,Lesson of Passion,5,9,9,18
4584,1115670,C64 & AMIGA Classix Remakes Sixpack 3,0,False,magnussoft,0,0,1,1
4585,1115690,"Yes, Your Grace",0,False,Brave At Night,8,1791,300,2091
4586,1114830,Armor Clash 3 [RTS],0,False,Windforce,5,37,28,65
4587,1114870,Lenna's Inception,0,False,Bytten Studio,8,107,12,119
4588,1114900,Ayo the Clown,0,False,Cloud M1,7,14,1,15
4589,1114910,Alone in the War,0,False,Fabio Cunha,0,1,0,1
4590,1115040,SincereMen,0,False,Utopia Entertainment,0,0,3,3
4591,1115060,Trace of the past,0,False,Konev,0,0,1,1
4592,1114360,Hentai Inumimi,0,False,GentleDriver,0,5,3,8
4593,1114430,Ballex,0,False,MushREB Games Studio,7,32,4,36
4594,1114460,Paranormal Detective: Escape from the 80's,0,False,LunaBeat,7,23,0,23
4595,1114520,Hero Among Us,0,False,Fire Horse Studio,6,7,3,10
4596,1114530,TTV3,0,False,Walter Machado,7,33,5,38
4597,1114620,Cloak and Dasher,0,False,Spirit Stone Studio LLC,7,11,0,11
4598,1114630,Dr. Tacocat,0,False,Jimi Demetriou,0,3,1,4
4599,1114700,Fight For Freedom,0,False,Shadowhite Animators LTD.,0,1,1,2
4600,1114710,KANNA,0,False,Hillside Studio,0,0,3,3
4601,1114730,Femdom Lines,0,False,Zee Vital,7,19,4,23
4602,1113930,Don't Die,0,False,Zgame Studio,0,4,1,5
4603,1113940,Electronic Super Joy 2,0,True,Michael Todd Games,7,14,1,15
4604,1113960,Pictures of Life,0,False,Bull&Ram,0,4,0,4
4605,1113970,Little Brother Jim,0,False,Tonguç Bodur,7,19,3,22
4606,1114000,King of Dragon Balls,0,False,Phoenixxx Games,0,2,6,8
4607,1114020,ZomB: Battlegrounds,0,False,Destruction Games,0,2,1,3
4608,1114110,Nightmare Game (噩梦游戏),0,False,两拳漫画,0,0,2,2
4609,1114130,My Koi,0,False,Sakana Studios,8,192,6,198
4610,1114210,Colloc,0,False,Pazolab Studio,0,3,0,3
4611,1114230,Gear Puzzle: the inheritance of grandpa,0,False,HunDong Studio,0,3,1,4
4612,1114270,1912 Titanic Mystery,0,False,Mad Data,0,2,2,4
4613,1113490,River Legends: A Fly Fishing Adventure,0,False,Dantat Studio,0,3,0,3
4614,1113620,Transparent Taskbar,0,False,chengcong,5,10,6,16
4615,1113650,Jaxon The Thief,0,False,Anamik Majumdar,0,0,2,2
4616,1113690,Senna and the Forest,0,False,Siddharth Sivaraman,7,11,0,11
4617,1113740,EasySave Backup,0,False,Giovanni Solinas,0,1,1,2
4618,1113750,Lost Artifacts: Frozen Queen,0,False,GameOn Production,0,4,5,9
4619,1113760,Roads of time,0,False,GameOn Production,0,3,0,3
4620,1113770,Lunch A Palooza,0,False,Seashell Studio,7,12,1,13
4621,1113780,Uncharted Tides: Port Royal,0,False,Cordelia Games,7,26,4,30
4622,1113000,Persona 4 Golden,0,False,ATLUS,9,29369,629,29998
4623,1113060,Magic Farm 3: The Ice Danger,0,False,Meridian'93,0,4,0,4
4624,1113110,The Stranger: Interactive Film,0,False,Giovanni Altrui,0,1,1,2
